"Ind","Obs","S1","S2","Jack1ab","Jack1abP","Jack2ab","Jack2abP","Chao1","Chao1P"
2671,54,7,3,61,62.0250342935528,65,66.0922496570645,59.25,60.2456275720165
2457,39,9,3,48,50.5562130177515,54,56.8757396449704,48,50.5562130177515
2720,55,12,3,67,70.1894214876033,76,79.6178512396694,71.5,74.9036363636364
2834,52,6,2,58,58.7721893491124,62,62.8254437869822,57,57.758875739645
2631,54,4,3,58,58.318244170096,59,59.323731138546,55.5,55.8045267489712
2591,56,5,5,61,61.4862882653061,61,61.4862882653061,57.6666666666667,58.1263818027211
2842,53,9,4,62,63.7878248487006,67,68.9320042719829,60.2,61.935920256319
2506,52,8,5,60,61.4201183431953,63,64.491124260355,56.6666666666667,58.0078895463511
2544,50,5,6,55,55.55,54,54.54,51.4285714285714,51.9428571428571
2659,49,6,8,55,55.8246563931695,53,53.7946688879634,50.6666666666667,51.4263501318895
2348,44,9,4,53,55.2174586776859,58,60.426652892562,51.2,53.3421487603306
2288,32,6,5,38,39.3359375,39,40.37109375,34.5,35.712890625
2260,35,8,5,43,45.2465306122449,46,48.4032653061224,39.6666666666667,41.7390476190476
2876,58,7,6,65,65.9467895362664,66,66.961355529132,61,61.8885255648038
2724,61,10,3,71,72.9080892233271,78,80.0962106960495,72.25,74.1916823434561
2980,59,4,5,63,63.2895719620799,62,62.2849755817294,60,60.2757828210284
3076,61,3,1,64,64.1547970975544,66,66.159634506853,62.5,62.6511690405805
2939,60,7,2,67,67.9119444444444,72,72.98,67,67.9119444444444
2629,37,4,4,41,41.4791818845873,41,41.4791818845873,38.2,38.6464572680789
2620,40,5,7,45,45.703125,43,43.671875,41.25,41.89453125
2404,42,8,8,50,51.8140589569161,50,51.8140589569161,45.1111111111111,46.7477954144621
2232,30,1,7,31,31.0344444444444,25,25.0277777777778,30,30.0333333333333
2498,52,10,6,62,64.292899408284,66,68.4408284023669,58.4285714285714,60.5893913778529
2424,51,11,6,62,64.884275278739,67,70.1168781237985,58.8571428571429,61.5952106332729
2572,58,7,6,65,65.9467895362664,66,66.961355529132,61,61.8885255648038
2659,55,9,6,64,65.7137190082645,67,68.7940495867769,60.1428571428571,61.7532939787485
2389,54,15,6,69,74.3240740740741,78,84.0185185185185,69,74.3240740740741
2603,43,7,6,50,51.3250405624662,51,52.3515413737155,46,47.2190373174689
2676,51,9,3,60,61.8685121107266,66,68.0553633217993,60,61.8685121107266
2843,52,6,5,58,58.7721893491124,59,59.7855029585799,54.5,55.2255917159763
2982,58,8,5,66,67.2556480380499,69,70.3127229488704,62.6666666666667,63.8588981371383
2521,42,2,6,44,44.0997732426304,40,40.0907029478458,42.1428571428571,42.2384191771947
2503,51,6,6,57,57.7889273356401,57,57.7889273356401,53.1428571428571,53.8783984181908
2431,36,7,2,43,44.6257716049383,48,49.8148148148148,43,44.6257716049383
3314,58,5,5,63,63.468192627824,63,63.468192627824,59.6666666666667,60.1100871977804
2547,57,10,2,67,69.0621729763004,75,77.3084025854109,72,74.2160664819945
2320,40,8,2,48,49.92,54,56.16,49.3333333333333,51.3066666666667
2589,56,11,6,67,69.5851403061225,72,74.7780612244898,63.8571428571429,66.3210185860058
3050,64,10,7,74,75.806640625,77,78.8798828125,69.625,71.3248291015625
2376,43,11,7,54,57.533802055165,58,61.7955651703624,49.875,53.1388588426176
2756,52,6,8,58,58.7721893491124,56,56.7455621301775,53.6666666666667,54.3811637080868
2488,49,10,7,59,61.457309454394,62,64.582257392753,54.625,56.9000937109538
2444,46,8,5,54,55.6332703213611,57,58.7240075614367,50.6666666666667,52.1991178323882
2480,41,5,4,46,46.6841165972635,47,47.698988697204,43,43.639500297442
3136,51,4,4,55,55.3383314109958,55,55.3383314109958,52.2,52.521107266436
2686,60,4,11,64,64.2844444444444,57,57.2533333333333,60.5,60.7688888888889
2630,56,7,6,63,63.984375,64,65,59,59.921875
2821,56,7,6,63,63.984375,64,65,59,59.921875
2905,57,5,6,62,62.4770698676516,61,61.4693751923669,58.4285714285714,58.8781603130634
3220,62,10,2,72,73.8730489073881,80,82.0811654526535,77,79.003121748179
2639,48,6,5,54,54.84375,55,55.859375,50.5,51.2890625
2938,40,5,6,45,45.703125,44,44.6875,41.4285714285714,42.0758928571429
2665,47,12,3,59,62.8460842009959,68,72.4327750113173,63.5,67.6394296061566
2799,50,3,5,53,53.1908,51,51.1836,50.5,50.6818
2826,66,11,4,77,79.1388888888889,84,86.3333333333333,77,79.1388888888889
2571,54,14,7,68,72.5706447187929,75,80.0411522633745,65.375,69.7692043895748
3054,65,8,5,73,74.105798816568,76,77.1512426035503,69.6666666666667,70.7219723865878
2699,51,7,5,58,59.0926566705113,60,61.1303344867359,54.5,55.5267204921184
2593,52,12,5,64,67.4082840236686,71,74.7810650887574,63,66.3550295857988
2779,56,3,7,59,59.1693239795918,55,55.1578443877551,56.375,56.536790497449
2709,57,11,6,68,70.5324715297015,73,75.7186826715913,64.8571428571429,67.2725673833707
2698,43,6,2,49,49.9540292049757,53,54.0319091400757,48,48.9345592212006
2420,39,10,7,49,52.2215647600263,52,55.4188034188034,44.625,47.5589250493097
2870,54,7,8,61,62.0250342935528,60,61.0082304526749,56.3333333333333,57.2799497027892
2644,41,4,8,45,45.4283164782867,41,41.390243902439,41.6666666666667,42.0632559984136
2713,45,6,6,51,51.9066666666667,51,51.9066666666667,47.1428571428571,47.9809523809524
2890,50,7,5,57,58.1172,59,60.1564,53.5,54.5486
3546,57,8,3,65,66.2803939673746,70,71.3788858110188,64,65.2606955986457
3564,38,5,3,43,43.744459833795,45,45.7790858725762,40.5,41.2011772853186
3435,28,4,2,32,32.6530612244898,34,34.6938775510204,30,30.6122448979592
3370,28,4,4,32,32.6530612244898,32,32.6530612244898,29.2,29.7959183673469
3345,23,4,2,27,27.8166351606805,29,29.8771266540643,25,25.7561436672968
3324,26,5,1,31,32.146449704142,35,36.2943786982249,31,32.146449704142
3355,22,1,3,23,23.047520661157,21,21.0433884297521,22,22.0454545454545
3263,19,1,3,20,20.0554016620499,18,18.0498614958449,19,19.0526315789474
3418,24,2,0,26,26.1805555555556,28,28.1944444444444,25,25.1736111111111
3404,16,1,1,17,17.06640625,17,17.06640625,16,16.0625
3538,19,1,3,20,20.0554016620499,18,18.0498614958449,19,19.0526315789474
3392,31,4,1,35,35.582726326743,38,38.6326742976067,34,34.5660770031217
3472,27,5,4,32,33.0973936899863,33,34.1316872427984,29,29.9945130315501
3358,28,5,2,33,34.0522959183673,36,37.1479591836735,31.3333333333333,32.3324829931973
3189,19,2,3,21,21.2326869806094,20,20.2216066481994,19.25,19.463296398892
3226,23,7,1,30,32.7788279773157,36,39.3345935727788,33.5,36.6030245746692
3476,20,3,1,23,23.5175,25,25.5625,21.5,21.98375
3657,33,5,3,38,38.8723599632691,40,40.9182736455464,35.5,36.3149678604224
3657,25,5,3,30,31.2,32,33.28,27.5,28.6
3384,26,5,2,31,32.146449704142,34,35.2573964497041,29.3333333333333,30.4181459566075
3289,23,5,3,28,29.3232514177694,30,31.4177693761815,25.5,26.7051039697543
3658,25,4,1,29,29.7424,32,32.8192,28,28.7168
3446,25,4,4,29,29.7424,29,29.7424,26.2,26.87072
3584,29,6,2,35,36.4982164090369,39,40.6694411414982,34,35.4554102259215
3451,23,4,4,27,27.8166351606805,27,27.8166351606805,24.2,24.9319470699433
3783,25,5,4,30,31.2,31,32.24,27,28.08
3750,24,2,1,26,26.1805555555556,27,27.1875,24.5,24.6701388888889
3841,29,4,1,33,33.627824019025,36,36.6848989298454,32,32.6087990487515
3694,27,3,3,30,30.3703703703704,30,30.3703703703704,27.75,28.0925925925926
3587,23,3,2,26,26.4423440453686,27,27.4593572778828,24,24.4083175803403
3368,21,4,2,25,25.907029478458,27,27.9795918367347,23,23.8344671201814
3720,26,1,2,27,27.0399408284024,26,26.0384615384615,26,26.0384615384615
3759,31,6,1,37,38.3860561914672,42,43.573361082206,38.5,39.9422476586889
3841,22,2,1,24,24.198347107438,25,25.2066115702479,22.5,22.6859504132231
3679,25,1,0,26,26.0416,27,27.0432,25,25.04
3948,29,4,4,33,33.627824019025,33,33.627824019025,30.2,30.7745541022592
3855,28,1,1,29,29.0369897959184,29,29.0369897959184,28,28.0357142857143
3708,24,4,2,28,28.7777777777778,30,30.8333333333333,26,26.7222222222222
3519,16,2,5,18,18.28125,15,15.234375,16.1666666666667,16.4192708333333
3899,34,11,3,45,49.7102076124567,53,58.5475778546713,47.75,52.748053633218
3800,16,3,1,19,19.66796875,21,21.73828125,17.5,18.115234375
3599,18,5,0,23,24.7746913580247,28,30.1604938271605,28,30.1604938271605
3607,24,8,4,32,35.5555555555556,36,40,29.6,32.8888888888889
4126,26,2,2,28,28.1656804733728,28,28.1656804733728,26.3333333333333,26.4891518737673
3833,24,5,0,29,30.2586805555556,34,35.4756944444444,34,35.4756944444444
3735,9,0,1,9,9,8,8,9,9
3668,13,4,0,17,18.6094674556213,21,22.9881656804734,19,20.7988165680473
3635,21,4,2,25,25.907029478458,27,27.9795918367347,23,23.8344671201814
3754,18,1,1,19,19.0586419753086,19,19.0586419753086,18,18.0555555555556
3902,28,2,0,30,30.1530612244898,32,32.1632653061224,29,29.1479591836735
3748,25,4,4,29,29.7424,29,29.7424,26.2,26.87072
4101,23,3,2,26,26.4423440453686,27,27.4593572778828,24,24.4083175803403
3919,22,1,2,23,23.047520661157,22,22.0454545454545,22,22.0454545454545
3788,20,2,5,22,22.22,19,19.19,20.1666666666667,20.3683333333333
3673,35,9,4,44,46.909387755102,49,52.24,42.2,44.9903673469388
3992,24,3,0,27,27.421875,30,30.46875,27,27.421875
3713,22,4,4,26,26.8595041322314,26,26.8595041322314,23.2,23.9669421487603
3811,25,1,1,26,26.0416,26,26.0416,25,25.04
3765,24,6,3,30,31.875,33,35.0625,27.75,29.484375
3695,24,3,2,27,27.421875,28,28.4375,25,25.390625
3877,29,3,3,32,32.3424494649227,32,32.3424494649227,29.75,30.0683709869203
4818,36,9,4,45,47.8125,50,53.125,43.2,45.9
4442,27,4,2,31,31.6803840877915,33,33.7242798353909,29,29.636488340192
4449,28,5,3,33,34.0522959183673,35,36.1160714285714,30.5,31.4725765306122
4477,30,5,6,35,35.9722222222222,34,34.9444444444444,31.4285714285714,32.3015873015873
4582,25,2,1,27,27.1728,28,28.1792,25.5,25.6632
4543,22,4,1,26,26.8595041322314,29,29.9586776859504,25,25.8264462809917
4287,42,10,7,52,54.9478458049887,55,58.1179138321995,47.625,50.3248299319728
4776,39,6,5,45,46.0650887573964,46,47.0887573964497,41.5,42.4822485207101
4537,23,4,3,27,27.8166351606805,28,28.8468809073724,24.5,25.2410207939509
4430,50,12,9,62,65.5712,65,68.744,56.6,59.86016
4369,26,5,2,31,32.146449704142,34,35.2573964497041,29.3333333333333,30.4181459566075
4472,34,6,5,40,41.2456747404844,41,42.2768166089965,36.5,37.636678200692
4734,39,9,4,48,50.5562130177515,53,55.8224852071006,46.2,48.6603550295858
4557,46,4,7,50,50.3780718336484,47,47.3553875236295,46.75,47.1034971644613
4587,43,10,4,53,55.8664142779881,59,62.1909140075717,52,54.8123309897242
4413,37,4,7,41,41.4791818845873,38,38.4441197954711,37.75,38.1911979547115
4589,34,9,3,43,46.0129757785467,49,52.4333910034602,43,46.0129757785467
4557,41,11,1,52,55.743010113028,62,66.4628197501487,68.5,73.4306960142772
4533,51,10,8,61,63.3452518262207,63,65.4221453287197,56,58.1530180699731
4603,43,6,7,49,49.9540292049757,48,48.9345592212006,44.875,45.7487155219037
4341,42,8,7,50,51.8140589569161,51,52.8503401360544,45.5,47.1507936507937
4382,38,12,3,50,54.9861495844875,59,64.8836565096953,54.5,59.9349030470914
4263,29,5,5,34,35.0107015457788,34,35.0107015457788,30.6666666666667,31.5782798256044
4510,43,8,7,51,52.7652785289346,52,53.7998918334235,46.5,48.1095186587345
4474,41,11,5,52,55.743010113028,58,62.1748958953004,50.1666666666667,53.7777116795558
4479,46,10,1,56,58.6465028355388,65,68.0718336483932,68.5,71.7372400756144
4131,21,6,3,27,29.2040816326531,30,32.4489795918367,24.75,26.7704081632653
4522,57,14,3,71,75.2831640504771,82,86.9467528470299,79.75,84.5610187750077
4384,34,6,4,40,41.2456747404844,42,43.3079584775086,37,38.1522491349481
4451,31,2,4,33,33.1373569198751,31,31.1290322580645,31.2,31.3298647242456
4602,48,9,4,57,59.00390625,62,64.1796875,55.2,57.140625
4380,35,10,6,45,48.6734693877551,49,53,41.4285714285714,44.8104956268222
4439,34,6,5,40,41.2456747404844,41,42.2768166089965,36.5,37.636678200692
4296,32,9,6,41,44.2431640625,44,47.48046875,37.1428571428571,40.0809151785714
4452,57,13,7,70,73.6411203447214,76,79.953216374269,66.75,70.2220683287165
4724,23,2,3,25,25.1890359168242,24,24.1814744801512,23.25,23.4258034026465
4659,31,4,5,35,35.582726326743,34,34.5660770031217,32,32.5327783558793
4468,28,4,2,32,32.6530612244898,34,34.6938775510204,30,30.6122448979592
4692,26,2,1,28,28.1656804733728,29,29.1715976331361,26.5,26.6568047337278
4822,31,5,2,36,36.9365244536941,39,40.0145681581686,34.3333333333333,35.2265001734305
4866,31,6,3,37,38.3860561914672,40,41.4984391259105,34.75,36.0517689906348
6304,32,5,4,37,37.9033203125,38,38.927734375,34,34.830078125
4827,34,6,3,40,41.2456747404844,43,44.3391003460208,37.75,38.9256055363322
4405,44,7,10,51,52.290805785124,48,49.2148760330578,45.9090909090909,47.0710462058603
4897,37,8,0,45,47.1037253469686,53,55.4777209642074,65,68.0387143900657
4876,43,8,8,51,52.7652785289346,51,52.7652785289346,46.1111111111111,47.7071690403221
4459,33,10,6,43,46.9485766758494,47,51.315886134068,39.4285714285714,43.0491932310114
4624,34,6,3,40,41.2456747404844,43,44.3391003460208,37.75,38.9256055363322
4980,29,6,1,35,36.4982164090369,40,41.7122473246135,36.5,38.0624256837099
4815,37,7,4,44,45.5748721694668,47,48.682249817385,41.2,42.6746530314098
4624,54,15,5,69,74.3240740740741,79,85.0956790123457,71.5,77.016975308642
4480,43,14,2,57,63.0421849648459,69,76.3142239048134,73.3333333333333,81.106904633135
4610,37,6,3,43,44.1307523739956,46,47.2096420745069,40.75,41.8215850986121
4875,53,13,8,66,69.9708081167675,71,75.2716269134924,61.6666666666667,65.376765159606
4501,37,7,7,44,45.5748721694668,44,45.5748721694668,39.625,41.0432797662527
4666,43,7,1,50,51.3250405624662,56,57.4840454299621,53.5,54.9177934018388
4615,48,6,5,54,54.84375,55,55.859375,50.5,51.2890625
4532,33,8,1,41,43.4095500459137,48,50.8209366391185,47,49.7621671258035
4601,34,6,3,40,41.2456747404844,43,44.3391003460208,37.75,38.9256055363322
4707,24,2,1,26,26.1805555555556,27,27.1875,24.5,24.6701388888889
4822,30,5,2,35,35.9722222222222,38,39.0555555555556,33.3333333333333,34.2592592592593
4544,38,11,4,49,53.1059556786704,56,60.6925207756233,49,53.1059556786704
4925,32,3,2,35,35.3076171875,36,36.31640625,33,33.2900390625
5306,28,5,0,33,34.0522959183673,38,39.2117346938776,38,39.2117346938776
5269,26,2,2,28,28.1656804733728,28,28.1656804733728,26.3333333333333,26.4891518737673
4833,33,5,3,38,38.8723599632691,40,40.9182736455464,35.5,36.3149678604224
4793,29,7,3,36,38.0975029726516,40,42.3305588585018,34.25,36.2455410225921
5203,30,4,1,34,34.6044444444444,37,37.6577777777778,33,33.5866666666667
4754,24,3,2,27,27.421875,28,28.4375,25,25.390625
5298,28,4,2,32,32.6530612244898,34,34.6938775510204,30,30.6122448979592
4457,29,7,4,36,38.0975029726516,39,41.2722948870392,33.2,35.1343638525565
5124,39,9,3,48,50.5562130177515,54,56.8757396449704,48,50.5562130177515
4765,46,11,8,57,60.2594517958412,60,63.4310018903592,52.1111111111111,55.0909997899601
4938,51,4,6,55,55.3383314109958,53,53.3260284505959,51.8571428571429,52.1761410446532
5004,56,13,6,69,72.718431122449,76,80.0956632653061,67.1428571428571,70.7612062682216
4751,53,11,5,64,66.7568529725881,70,73.0153079387682,62.1666666666667,64.8445472884775
4985,27,3,5,30,30.3703703703704,28,28.3456790123457,27.5,27.8395061728395
4667,28,7,1,35,37.1875,41,43.5625,38.5,40.90625
4707,24,5,1,29,30.2586805555556,33,34.4322916666667,29,30.2586805555556
5189,25,4,1,29,29.7424,32,32.8192,28,28.7168
5040,30,1,2,31,31.0344444444444,30,30.0333333333333,30,30.0333333333333
5262,32,3,4,35,35.3076171875,34,34.298828125,32.6,32.8865234375
4902,29,4,5,33,33.627824019025,32,32.6087990487515,30,30.5707491082045
4839,30,4,5,34,34.6044444444444,33,33.5866666666667,31,31.5511111111111
4599,30,7,4,37,39.0144444444445,40,42.1777777777778,34.2,36.062
5061,41,8,1,49,50.8655562165378,56,58.1320642474717,55,57.093991671624
5404,35,6,2,41,42.2048979591837,45,46.3224489795918,40,41.1755102040816
5116,59,10,5,69,70.9821890261419,74,76.1258259120942,66.5,68.4103705831658
5065,60,9,7,69,70.5525,71,72.5975,64.5,65.95125
4876,42,10,3,52,54.9478458049887,59,62.3446712018141,53.25,56.2687074829932
5035,32,5,0,37,37.9033203125,42,43.025390625,42,43.025390625
4739,24,6,3,30,31.875,33,35.0625,27.75,29.484375
4815,31,6,3,37,38.3860561914672,40,41.4984391259105,34.75,36.0517689906348
4755,39,9,3,48,50.5562130177515,54,56.8757396449704,48,50.5562130177515
6227,37,12,4,49,54.1541271000731,57,62.9956172388605,50.2,55.4803506208912
6418,37,9,1,46,48.7216946676406,54,57.1950328707085,55,58.254200146092
6193,20,3,1,23,23.5175,25,25.5625,21.5,21.98375
6431,26,4,5,30,30.7100591715976,29,29.6863905325444,27,27.6390532544379
7004,65,7,5,72,72.8350295857988,74,74.858224852071,68.5,69.2944378698225
6288,21,3,1,24,24.4897959183673,26,26.530612244898,22.5,22.9591836734694
6413,33,5,4,38,38.8723599632691,39,39.8953168044077,35,35.8034894398531
7169,31,4,2,35,35.582726326743,37,37.6160249739854,33,33.5494276795005
6753,30,8,2,38,40.7022222222222,44,47.1288888888889,39.3333333333333,42.1303703703704
6581,48,11,8,59,62.0985243055556,62,65.2560763888889,54.1111111111111,56.9528838734568
6649,76,18,8,94,99.2728531855956,104,109.83379501385,93,98.2167590027701
6409,52,10,9,62,64.292899408284,63,65.3298816568047,56.5,58.5894970414201
6402,30,5,5,35,35.9722222222222,35,35.9722222222222,31.6666666666667,32.5462962962963
6763,34,4,7,38,38.5259515570934,35,35.4844290657439,34.75,35.2309688581315
6255,27,6,1,33,34.6296296296296,38,39.8765432098765,34.5,36.2037037037037
6286,30,8,5,38,40.7022222222222,41,43.9155555555556,34.6666666666667,37.1318518518518
6163,19,9,2,28,34.2825484764543,35,42.8531855955679,31,37.9556786703601
6425,39,5,5,44,44.7232084155161,44,44.7232084155161,40.6666666666667,41.3350865658558
6405,27,7,4,34,36.2853223593964,37,39.4869684499314,31.2,33.2971193415638
6586,51,2,1,53,53.081507112649,54,54.083044982699,51.5,51.579200307574
6275,34,7,6,41,42.7378892733564,42,43.780276816609,37,38.568339100346
6617,25,5,0,30,31.2,35,36.4,35,36.4
6735,37,4,5,41,41.4791818845873,40,40.4674945215486,38,38.4441197954711
6516,48,7,10,55,56.1697048611111,52,53.1059027777778,49.9090909090909,50.9705255681818
7418,38,5,6,43,43.744459833795,42,42.7271468144044,39.4285714285714,40.1111990502572
6662,50,5,7,55,55.55,53,53.53,51.25,51.7625
6946,35,3,2,38,38.2791836734694,39,39.2865306122449,36,36.2644897959184
6441,23,2,3,25,25.1890359168242,24,24.1814744801512,23.25,23.4258034026465
6643,50,11,7,61,63.9524,65,68.146,56.875,59.62775
6472,38,3,5,41,41.255540166205,39,39.2430747922438,38.5,38.7399584487535
6422,26,5,7,31,32.146449704142,29,30.0724852071006,27.25,28.2577662721894
6186,22,8,2,30,33.9669421487603,36,40.7603305785124,31.3333333333333,35.4765840220386
6536,41,7,7,48,49.3991671624033,48,49.3991671624033,43.625,44.8966389054134
6520,34,5,3,39,39.8434256055363,41,41.886678200692,36.5,37.2893598615917
6616,42,7,7,49,50.3611111111111,49,50.3611111111111,44.625,45.8645833333333
6613,38,7,8,45,46.5270083102493,44,45.4930747922438,40.3333333333333,41.7019852262235
6474,24,3,2,27,27.421875,28,28.4375,25,25.390625
7570,46,5,4,51,51.6025519848771,52,52.6143667296786,48,48.5671077504726
7277,80,10,8,90,91.40625,92,93.4375,85,86.328125
6376,40,12,4,52,56.68,60,65.4,53.2,57.988
6803,37,9,3,46,48.7216946676406,52,55.0766983199416,46,48.7216946676406
6960,31,4,2,35,35.582726326743,37,37.6160249739854,33,33.5494276795005
6690,56,8,12,64,65.3061224489796,60,61.2244897959184,58.1538461538462,59.3406593406593
6270,16,5,3,21,23.05078125,23,25.24609375,18.5,20.306640625
7528,65,10,7,75,76.7751479289941,78,79.8461538461538,70.625,72.2965976331361
8276,51,7,9,58,59.0926566705113,56,57.0549788542868,53.1,54.1003460207613
7480,57,10,6,67,69.0621729763004,71,73.1852877808556,63.4285714285714,65.3808204722332
7499,53,7,10,60,61.0466358134567,57,57.9943040227839,54.9090909090909,55.8669212595877
7276,40,9,6,49,51.480625,52,54.6325,45.1428571428571,47.4282142857143
7586,49,11,2,60,63.0237401082882,69,72.4773011245314,67.3333333333333,70.726641677079
7883,49,8,4,57,58.5193669304456,61,62.6259891711787,54.6,56.0553935860058
7900,48,10,4,58,60.5173611111111,64,66.7777777777778,57,59.4739583333333
7407,41,7,5,48,49.3991671624033,50,51.4574657941701,44.5,45.7971445568114
8672,44,7,7,51,52.290805785124,51,52.290805785124,46.625,47.8050748966942
7918,57,7,5,64,64.9652200677131,66,66.9953831948292,60.5,61.4124345952601
7477,57,5,8,62,62.4770698676516,59,59.4539858417975,58.1111111111111,58.5582572415444
7388,55,11,8,66,68.64,69,71.76,61.1111111111111,63.5555555555556
7692,56,6,4,62,62.7117346938776,64,64.734693877551,59,59.6772959183673
7397,44,7,8,51,52.290805785124,50,51.2654958677686,46.3333333333333,47.5060261707989
7645,53,10,9,63,65.2427910288359,64,66.2783908864365,57.5,59.5469918120328
8037,55,12,8,67,70.1894214876033,71,74.3798347107438,62.3333333333333,65.3006060606061
7546,52,10,6,62,64.292899408284,66,68.4408284023669,58.4285714285714,60.5893913778529
7519,60,9,5,69,70.5525,73,74.6425,66,67.485
7446,58,8,9,66,67.2556480380499,65,66.2366230677764,60.8,61.9567181926278
7597,41,9,6,50,52.4092801903629,53,55.5538370017847,46.1428571428571,48.3662785756777
8566,33,7,8,40,41.7998163452709,39,40.7548209366391,35.3333333333333,36.9231711049893
7704,54,6,7,60,60.7407407407407,59,59.7283950617284,55.875,56.5648148148148
7645,68,11,11,79,81.0672577854671,79,81.0672577854671,72.5833333333333,74.4826809400231
7595,44,15,2,59,65.8569214876033,72,80.3677685950413,79,88.1813016528926
8597,54,8,6,62,63.360768175583,64,65.4046639231824,58,59.2729766803841
11437,43,9,6,52,54.2779881016766,55,57.4094104921579,48.1428571428571,50.2518735996291
11456,41,14,5,55,61.4128494943486,64,71.4622248661511,56.1666666666667,62.7155463018045
11251,38,11,2,49,53.1059556786704,58,62.8601108033241,56.3333333333333,61.0537857802401
11698,53,6,5,59,59.7561409754361,60,60.7689569241723,55.5,56.2112851548594
11437,58,17,4,75,81.4432223543401,88,95.5600475624257,85.2,92.5195005945303
11333,41,10,6,51,54.0339083878644,55,58.2718619869125,47.4285714285714,50.2500212458571
11514,48,12,5,60,63.75,67,71.1875,59,62.6875
11472,46,6,9,52,52.8846880907372,49,49.8336483931947,47.5,48.3081285444234
11466,65,11,11,76,78.1765680473373,76,78.1765680473373,69.5833333333333,71.576134122288
11264,36,12,3,48,53.3333333333333,57,63.3333333333333,52.5,58.3333333333333
11514,45,10,2,55,57.7160493827161,63,66.1111111111111,60,62.962962962963
11521,62,13,9,75,78.2973465140479,79,82.4732049947971,69.8,72.8687304890739
11529,45,7,6,52,53.2582716049383,53,54.2824691358025,48,49.1614814814815
11625,49,7,3,56,57.1428571428571,60,61.2244897959184,54.25,55.3571428571429
11527,37,4,4,41,41.4791818845873,41,41.4791818845873,38.2,38.6464572680789
11633,48,10,3,58,60.5173611111111,65,67.8211805555555,59.25,61.8216145833333
11605,52,7,5,59,60.0691568047337,61,62.105399408284,55.5,56.5057322485207
11563,36,4,1,40,40.4938271604938,43,43.5308641975309,39,39.4814814814815
11662,46,4,4,50,50.3780718336484,50,50.3780718336484,47.2,47.5568998109641
11418,35,7,3,42,43.68,46,47.84,40.25,41.86
11419,30,7,2,37,39.0144444444445,42,44.2866666666667,37,39.0144444444445
11641,54,9,6,63,64.75,66,67.8333333333333,59.1428571428571,60.7857142857143
11466,42,10,5,52,54.9478458049887,57,60.2312925170068,49.5,52.3061224489796
11776,44,9,4,53,55.2174586776859,58,60.426652892562,51.2,53.3421487603306
11606,38,5,4,43,43.744459833795,44,44.7617728531856,40,40.6925207756233
11448,35,10,7,45,48.6734693877551,48,51.9183673469388,40.625,43.9413265306123
11641,25,2,0,27,27.1728,29,29.1856,26,26.1664
11885,60,7,8,67,67.9119444444444,66,66.8983333333333,62.3333333333333,63.1817592592593
11744,75,13,8,88,90.6439111111111,93,95.7941333333333,83.6666666666667,86.1803851851852
11637,28,7,2,35,37.1875,40,42.5,35,37.1875
11884,53,10,8,63,65.2427910288359,65,67.313990744037,58,60.064791740833
12305,73,5,7,78,78.3659223118784,76,76.3565396884969,74.25,74.5983298930381
11624,48,9,5,57,59.00390625,61,63.14453125,54,55.8984375
11895,54,10,4,64,66.1947873799726,70,72.400548696845,63,65.1604938271605
11801,46,4,9,50,50.3780718336484,45,45.3402646502836,46.6,46.9523629489603
11827,48,3,3,51,51.19921875,51,51.19921875,48.75,48.9404296875
11575,43,7,2,50,51.3250405624662,55,56.4575446187128,50,51.3250405624662
11764,53,3,7,56,56.1794232823069,52,52.1666073335707,53.375,53.5460128159487
11717,44,3,11,47,47.2184917355372,39,39.1813016528926,44.25,44.4557076446281
11957,55,8,5,63,64.3328925619835,66,67.3963636363636,59.6666666666667,60.9290358126722
12093,60,8,8,68,69.2088888888889,68,69.2088888888889,63.1111111111111,64.2330864197531
11609,41,9,6,50,52.4092801903629,53,55.5538370017847,46.1428571428571,48.3662785756777
11650,28,7,2,35,37.1875,40,42.5,35,37.1875
11998,49,3,9,52,52.1949187838401,46,46.1724281549354,49.3,49.484798000833
11814,50,10,9,60,62.4,61,63.44,54.5,56.68
11947,61,10,4,71,72.9080892233271,77,79.0693361999463,70,71.8812147272239
11887,60,10,11,70,71.9444444444444,69,70.9166666666667,63.75,65.5208333333333
12135,47,13,6,60,64.5903123585333,67,72.1258488003622,58.1428571428571,62.5910884045787
12218,59,9,4,68,69.5823039356507,73,74.6986498132721,66.2,67.740419419707
12010,61,18,3,79,85.8787960225746,94,102.18489653319,99.25,107.892031711905
11874,48,10,6,58,60.5173611111111,62,64.6909722222222,54.4285714285714,56.7909226190476
12396,70,14,5,84,87.36,93,96.72,85.1666666666667,88.5733333333333
12002,47,6,4,53,53.8637392485287,55,55.8963331824355,50,50.8148483476686
11920,45,15,3,60,66.6666666666667,72,80,71.25,79.1666666666667
12009,41,6,3,47,48.0065437239738,50,51.0707911957168,44.75,45.7083581201666
12047,42,10,3,52,54.9478458049887,59,62.3446712018141,53.25,56.2687074829932
14998,49,4,4,53,53.3531861724282,53,53.3531861724282,50.2,50.5345272802999
14583,56,7,7,63,63.984375,63,63.984375,58.625,59.541015625
14642,61,11,9,72,74.3413061005106,74,76.4063423810804,66.5,68.6624563289438
15203,38,4,5,42,42.4653739612188,41,41.4542936288089,39,39.4321329639889
14846,49,3,5,52,52.1949187838401,50,50.1874219075385,49.5,49.6855476884631
14556,15,3,1,18,18.72,20,20.8,16.5,17.16
14320,44,10,3,54,56.7892561983471,61,64.150826446281,55.25,58.1038223140496
15787,37,8,3,45,47.1037253469686,50,52.3374726077429,44,46.0569758948137
14858,59,8,8,67,68.231829933927,67,68.231829933927,62.1111111111111,63.25305627374
14115,11,2,1,13,13.4297520661157,14,14.4628099173554,11.5,11.8801652892562
15093,36,4,5,40,40.4938271604938,39,39.4814814814815,37,37.4567901234568
14141,18,4,3,22,23.0864197530864,23,24.1358024691358,19.5,20.462962962963
14760,56,8,9,64,65.3061224489796,63,64.2857142857143,58.8,60
15472,30,5,3,35,35.9722222222222,37,38.0277777777778,32.5,33.4027777777778
14310,32,10,5,42,46.1015625,47,51.58984375,39.5,43.357421875
14786,47,1,9,48,48.0217292892712,40,40.0181077410593,47,47.0212765957447
15195,43,3,5,46,46.2239048134127,44,44.2141698215251,43.5,43.7117360735533
14443,19,4,1,23,24.0193905817175,26,27.1523545706371,22,22.9750692520776
14160,15,5,0,20,22.2222222222222,25,27.7777777777778,25,27.7777777777778
14101,10,4,1,14,16.24,17,19.72,13,15.08
15271,65,8,1,73,74.105798816568,80,81.2118343195266,79,80.1966863905325
14502,49,9,6,58,59.9566847147022,61,63.057892544773,54.1428571428571,55.9694175046112
14468,47,7,7,54,55.1978270710729,54,55.1978270710729,49.625,50.7257808963332
15548,32,1,3,33,33.0322265625,31,31.0302734375,32,32.03125
14557,54,7,6,61,62.0250342935528,62,63.0418381344307,57,57.9578189300412
14667,63,14,10,77,80.8024691358025,81,85,71.2727272727273,74.7923681257015
14673,54,8,1,62,63.360768175583,69,70.5144032921811,68,69.4924554183813
14156,13,1,4,14,14.0828402366864,11,11.0650887573965,13,13.0769230769231
15379,27,6,2,33,34.6296296296296,37,38.8271604938272,32,33.5802469135802
14526,40,13,5,53,58.598125,61,67.443125,53,58.598125
14729,49,7,2,56,57.1428571428571,61,62.2448979591837,56,57.1428571428571
15005,61,5,5,66,66.4434291857028,66,66.4434291857028,62.6666666666667,63.0877004389501
14336,32,6,3,38,39.3359375,41,42.44140625,35.75,37.0068359375
14827,52,8,9,60,61.4201183431953,59,60.396449704142,54.8,56.0970414201183
14966,58,8,3,66,67.2556480380499,71,72.3507728894174,65,66.2366230677764
14413,37,10,4,47,50.4331628926224,53,56.8714390065741,46,49.3601168736304
14280,29,4,5,33,33.627824019025,32,32.6087990487515,30,30.5707491082045
14684,67,13,6,80,83.0118066384495,87,90.2753397193139,78.1428571428571,81.0847468414855
14955,56,8,6,64,65.3061224489796,66,67.3469387755102,60,61.2244897959184
14799,58,8,5,66,67.2556480380499,69,70.3127229488704,62.6666666666667,63.8588981371383
14508,53,13,7,66,69.9708081167675,72,76.3317906728373,62.75,66.5252758988964
14486,32,5,4,37,37.9033203125,38,38.927734375,34,34.830078125
14676,30,5,2,35,35.9722222222222,38,39.0555555555556,33.3333333333333,34.2592592592593
14892,18,3,3,21,21.5833333333333,21,21.5833333333333,18.75,19.2708333333333
14499,42,10,1,52,54.9478458049887,61,64.4580498866213,64.5,68.156462585034
15680,28,4,4,32,32.6530612244898,32,32.6530612244898,29.2,29.7959183673469
16600,26,3,4,29,29.3860946745562,28,28.3727810650888,26.6,26.9541420118343
15092,42,9,5,51,53.3418367346939,55,57.5255102040816,48,50.2040816326531
15094,64,13,5,77,80.177001953125,85,88.507080078125,77,80.177001953125
15662,45,9,4,54,56.16,59,61.36,52.2,54.288
14696,59,9,10,68,69.5823039356507,67,68.5590347601264,62.2727272727273,63.7217622940116
14850,48,9,6,57,59.00390625,60,62.109375,53.1428571428571,55.0111607142857
15456,38,3,3,41,41.255540166205,41,41.255540166205,38.75,38.9915166204986
14753,55,9,5,64,65.7137190082645,68,69.820826446281,61,62.6333884297521
14553,52,5,7,57,57.5269970414201,55,55.5085059171598,53.25,53.7423261834319
14763,51,7,5,58,59.0926566705113,60,61.1303344867359,54.5,55.5267204921184
17670,45,3,7,48,48.2133333333333,44,44.1955555555556,45.375,45.5766666666667
14576,45,9,8,54,56.16,55,57.2,49,50.96
15718,73,5,10,78,78.3659223118784,73,73.3424657534247,73.9090909090909,74.2558214913253
14708,51,9,6,60,61.8685121107266,63,64.961937716263,56.1428571428571,57.8912506178942
14804,55,16,4,71,77.0085950413223,83,90.024132231405,79,85.6856198347107
14751,43,9,4,52,54.2779881016766,57,59.4970254191455,50.2,52.3991346673878
14569,55,7,13,62,63.0042975206612,56,56.9071074380165,56.5,57.4152066115702
14837,64,13,4,77,80.177001953125,86,89.54833984375,79.6,82.88427734375
15083,48,6,7,54,54.84375,53,53.828125,49.875,50.654296875
14872,59,10,6,69,70.9821890261419,73,75.0970985349038,65.4285714285714,67.3081626790331
14568,55,7,8,62,63.0042975206612,61,61.9880991735537,57.3333333333333,58.2620385674931
14650,48,6,5,54,54.84375,55,55.859375,50.5,51.2890625
14839,52,6,8,58,58.7721893491124,56,56.7455621301775,53.6666666666667,54.3811637080868
15374,26,2,5,28,28.1656804733728,25,25.1479289940828,26.1666666666667,26.3214990138067
14802,52,7,7,59,60.0691568047337,59,60.0691568047337,54.625,55.6148761094675
15331,64,4,7,68,68.265625,65,65.25390625,64.75,65.0029296875
15279,45,10,3,55,57.7160493827161,62,65.0617283950617,56.25,59.0277777777778
14531,53,14,8,67,71.6749733001068,73,78.0936276254895,63.1111111111111,67.5147343855069
15108,64,10,9,74,75.806640625,75,76.8310546875,68.5,70.17236328125
14928,51,3,4,54,54.1868512110727,53,53.1833910034602,51.6,51.7785467128028
15012,52,14,4,66,70.7840236686391,76,81.508875739645,70.2,75.2884615384615
15057,53,8,5,61,62.3898184407262,64,65.4581701673193,57.6666666666667,58.9805387445117
14727,54,10,12,64,66.1947873799726,62,64.1262002743484,57.4615384615385,59.4320987654321
14844,58,11,8,69,71.4818668252081,72,74.589774078478,64.1111111111111,66.4171290791386
14572,46,12,4,58,61.9470699432892,66,70.4914933837429,59.2,63.2287334593573
14943,55,7,4,62,63.0042975206612,65,66.0528925619835,59.2,60.1589421487603
14632,48,9,8,57,59.00390625,58,60.0390625,52,53.828125
15882,61,5,5,66,66.4434291857028,66,66.4434291857028,62.6666666666667,63.0877004389501
14799,54,12,6,66,69.2592592592593,72,75.5555555555556,63.4285714285714,66.5608465608466
14771,56,9,12,65,66.6788903061224,62,63.6014030612245,58.7692307692308,60.2871860282575
14851,32,3,5,35,35.3076171875,33,33.2900390625,32.5,32.78564453125
14626,35,4,3,39,39.509387755102,40,40.5224489795918,36.5,36.9767346938775
15378,59,7,4,66,66.9290433783396,69,69.9712726228095,63.2,64.0896294168342
15094,21,1,1,22,22.0498866213152,22,22.0498866213152,21,21.047619047619
15108,57,9,8,66,67.6454293628809,67,68.6703601108033,61,62.5207756232687
15653,47,10,5,57,59.5803531009507,62,64.8066998641919,54.5,56.96717971933
14707,25,0,2,25,25,23,23,25,25
14797,47,4,9,51,51.3693979176098,46,46.3331824354912,47.6,47.9447713897691
14875,58,13,10,71,74.5668846611177,74,77.717598097503,65.0909090909091,68.3609339530862
14645,34,6,6,40,41.2456747404844,40,41.2456747404844,36.1428571428571,37.268413247652
14734,38,3,9,41,41.255540166205,35,35.2181440443213,38.3,38.5387119113573
14808,52,5,9,57,57.5269970414201,53,53.4900147928994,53,53.4900147928994
14988,47,6,4,53,53.8637392485287,55,55.8963331824355,50,50.8148483476686
15300,53,9,8,62,63.7878248487006,63,64.8166607333571,57,58.6436454254183
14990,56,4,7,60,60.3061224489796,57,57.2908163265306,56.75,57.0395408163265
14932,48,9,4,57,59.00390625,62,64.1796875,55.2,57.140625
14877,43,8,3,51,52.7652785289346,56,57.9383450513791,50,51.7306652244457
14778,40,10,3,50,53.125,57,60.5625,51.25,54.453125
14947,51,9,8,60,61.8685121107266,61,62.8996539792388,55,56.7128027681661
14906,52,7,6,59,60.0691568047337,60,61.0872781065089,55,55.9966715976331
14867,45,8,6,53,54.6750617283951,55,56.7382716049383,49,50.5486419753086
14892,45,11,2,56,59.3461728395062,65,68.8839506172839,63.3333333333333,67.117695473251
14800,45,11,3,56,59.3461728395062,64,67.8241975308642,58.75,62.2604938271605
14694,33,4,6,37,37.5436179981635,35,35.514233241506,33.8571428571429,34.3545848091303
14822,42,8,4,50,51.8140589569161,54,55.9591836734694,47.6,49.3269841269841
14938,52,8,6,60,61.4201183431953,62,63.4674556213018,56,57.3254437869822
14903,52,11,3,63,65.8191568047337,71,74.1771449704142,65.75,68.6922152366864
18317,66,13,3,79,82.0649678604224,89,92.4529384756657,85.5,88.8171487603306
17361,40,5,6,45,45.703125,44,44.6875,41.4285714285714,42.0758928571429
17556,28,5,4,33,34.0522959183673,34,35.0841836734694,30,30.9566326530612
17272,51,11,8,62,64.884275278739,65,68.0238369857747,57.1111111111111,59.7679524969029
17696,57,9,11,66,67.6454293628809,64,65.595567867036,60,61.4958448753463
17489,40,10,6,50,53.125,54,57.375,46.4285714285714,49.3303571428571
17515,55,10,3,65,67.1487603305785,72,74.3801652892562,66.25,68.4400826446281
17736,31,6,5,37,38.3860561914672,38,39.423517169615,33.5,34.7549427679501
17483,20,3,3,23,23.5175,23,23.5175,20.75,21.216875
17858,27,4,0,31,31.6803840877915,35,35.7681755829904,33,33.7242798353909
17299,46,13,6,59,63.7121928166352,66,71.2712665406427,57.1428571428571,61.7067242776127
17416,62,18,7,80,86.7429760665973,91,98.6701352757544,81.125,87.9627991675338
17712,25,2,0,27,27.1728,29,29.1856,26,26.1664
17456,22,8,4,30,33.9669421487603,34,38.495867768595,27.6,31.2495867768595
17681,50,10,5,60,62.4,65,67.6,57.5,59.8
17896,23,5,4,28,29.3232514177694,29,30.3705103969754,25,26.1814744801512
17440,43,9,3,52,54.2779881016766,58,60.5408328826393,52,54.2779881016766
17610,54,12,4,66,69.2592592592593,74,77.6543209876543,67.2,70.5185185185185
19744,29,4,0,33,33.627824019025,37,37.7039239001189,35,35.6658739595719
17761,23,5,4,28,29.3232514177694,29,30.3705103969754,25,26.1814744801512
17532,24,3,1,27,27.421875,29,29.453125,25.5,25.8984375
17459,46,11,8,57,60.2594517958412,60,63.4310018903592,52.1111111111111,55.0909997899601
17457,40,6,7,46,47.035,45,46.0125,41.875,42.8171875
17731,57,7,2,64,64.9652200677131,69,70.0406278855032,64,64.9652200677131
18370,24,3,4,27,27.421875,26,26.40625,24.6,24.984375
17891,15,3,1,18,18.72,20,20.8,16.5,17.16
17653,24,4,1,28,28.7777777777778,31,31.8611111111111,27,27.75
17454,47,9,8,56,58.0534178361249,57,59.09008601177,51,52.8700769578995
17769,56,13,5,69,72.718431122449,77,81.1495535714286,69,72.718431122449
17761,41,8,3,49,50.8655562165378,54,56.0559190957763,48,49.8274836406901
17389,45,6,5,51,51.9066666666667,52,52.9244444444444,47.5,48.3444444444444
17487,20,4,3,24,24.96,25,26,21.5,22.36
17772,26,4,3,30,30.7100591715976,31,31.7337278106509,27.5,28.1508875739645
17780,23,4,2,27,27.8166351606805,29,29.8771266540643,25,25.7561436672968
17746,47,4,6,51,51.3693979176098,49,49.3549117247623,47.8571428571429,48.2037767574209
18019,33,4,3,37,37.5436179981635,38,38.5583103764922,34.5,35.0068870523416
17317,22,1,5,23,23.047520661157,19,19.0392561983471,22,22.0454545454545
17362,20,5,1,25,26.5625,29,30.8125,25,26.5625
17372,21,4,1,25,25.907029478458,28,29.015873015873,24,24.8707482993197
17497,46,13,3,59,63.7121928166352,69,74.5108695652174,65.5,70.7313327032136
17421,29,3,3,32,32.3424494649227,32,32.3424494649227,29.75,30.0683709869203
17400,41,12,8,53,57.5401546698394,57,61.8828078524688,48.3333333333333,52.4737259567718
17432,37,10,3,47,50.4331628926224,54,57.9444850255661,48.25,51.7744704163623
17724,48,15,8,63,69.15234375,70,76.8359375,59.6666666666667,65.4934895833333
17918,26,5,1,31,32.146449704142,35,36.2943786982249,31,32.146449704142
18343,25,3,1,28,28.4032,30,30.432,26.5,26.8816
17631,41,6,4,47,48.0065437239738,49,50.0493753718025,44,44.9422962522308
17621,42,8,7,50,51.8140589569161,51,52.8503401360544,45.5,47.1507936507937
17655,40,8,8,48,49.92,48,49.92,43.1111111111111,44.8355555555556
17853,20,5,2,25,26.5625,28,29.75,23.3333333333333,24.7916666666667
17715,21,4,1,25,25.907029478458,28,29.015873015873,24,24.8707482993197
17804,42,10,6,52,54.9478458049887,56,59.1746031746032,48.4285714285714,51.1739552964043
18121,37,8,2,45,47.1037253469686,51,53.3842220598977,46.3333333333333,48.4993912831751
17433,35,6,5,41,42.2048979591837,42,43.2342857142857,37.5,38.6020408163265
19163,16,2,1,18,18.28125,19,19.296875,16.5,16.7578125
17576,29,7,4,36,38.0975029726516,39,41.2722948870392,33.2,35.1343638525565
17527,60,19,10,79,86.9219444444444,88,96.8244444444444,75.5454545454545,83.1209848484848
17780,55,16,7,71,77.0085950413223,80,86.7702479338843,70,75.9239669421488
17514,21,2,3,23,23.2086167800454,22,22.1995464852608,21.25,21.4427437641723
17906,20,1,1,21,21.0525,21,21.0525,20,20.05
17768,37,5,5,42,42.7669831994156,42,42.7669831994156,38.6666666666667,39.372778183589
17964,35,3,5,38,38.2791836734694,36,36.2644897959184,35.5,35.7608163265306
17533,41,15,5,56,63.4955383700178,66,74.8340273646639,58.5,66.3301606186794
18267,38,4,5,42,42.4653739612188,41,41.4542936288089,39,39.4321329639889
18091,34,4,5,38,38.5259515570934,37,37.5121107266436,35,35.4844290657439
17540,38,9,8,47,49.6364265927978,48,50.6925207756233,42,44.3559556786704
17824,44,10,3,54,56.7892561983471,61,64.150826446281,55.25,58.1038223140496
18228,30,4,4,34,34.6044444444444,34,34.6044444444444,31.2,31.7546666666667
18300,30,2,2,32,32.1422222222222,32,32.1422222222222,30.3333333333333,30.4681481481481
17809,38,10,8,48,51.3240997229917,50,53.4626038781163,43,45.9778393351801
17946,61,5,12,66,66.4434291857028,59,59.3963988175222,61.7692307692308,62.1842350071321
17864,23,5,1,28,29.3232514177694,32,33.5122873345936,28,29.3232514177694
18322,22,5,3,27,28.3946280991736,29,30.4979338842975,24.5,25.7654958677686
18110,20,4,1,24,24.96,27,28.08,23,23.92
18004,45,7,4,52,53.2582716049383,55,56.3308641975309,49.2,50.3905185185185
17988,27,6,4,33,34.6296296296296,35,36.7283950617284,30,31.4814814814815
17786,55,14,8,69,73.4707438016529,75,79.8595041322314,65.1111111111111,69.3298806244261
17876,44,8,2,52,53.7190082644628,58,59.9173553719008,53.3333333333333,55.0964187327824
18014,45,10,6,55,57.7160493827161,59,61.9135802469136,51.4285714285714,53.968253968254
17832,52,12,5,64,67.4082840236686,71,74.7810650887574,63,66.3550295857988
17950,70,13,8,83,85.8626530612245,88,91.0351020408163,78.6666666666667,81.3798639455782
17787,39,8,3,47,48.9776462853386,52,54.1880341880342,46,47.9355687047995
17843,65,9,16,74,75.4186982248521,67,68.2844970414201,67.1176470588235,68.4043995823181
17731,40,6,3,46,47.035,49,50.1025,43.75,44.734375
18207,54,4,4,58,58.318244170096,58,58.318244170096,55.2,55.5028806584362
17896,46,12,2,58,61.9470699432892,68,72.6275992438563,68,72.6275992438563
17817,38,4,3,42,42.4653739612188,43,43.4764542936288,39.5,39.9376731301939
18183,68,11,5,79,81.0672577854671,85,87.2242647058823,77.1666666666667,79.1859501153403
17806,43,7,7,50,51.3250405624662,50,51.3250405624662,45.625,46.8340995132504
18385,18,1,0,19,19.0586419753086,20,20.0617283950617,18,18.0555555555556
18668,32,5,6,37,37.9033203125,36,36.87890625,33.4285714285714,34.2446986607143
17826,44,6,5,50,50.9297520661157,51,51.948347107438,46.5,47.3646694214876
17701,22,5,2,27,28.3946280991736,30,31.5495867768595,25.3333333333333,26.6418732782369
18544,53,2,6,55,55.0783196867213,51,51.0726237095052,53.1428571428571,53.2185322687281
18573,50,5,6,55,55.55,54,54.54,51.4285714285714,51.9428571428571
18562,53,9,5,62,63.7878248487006,66,67.9031683873264,59,60.7013171947312
18484,44,12,3,56,60.1652892561983,65,69.8347107438017,60.5,65
18697,51,12,4,63,66.4878892733564,71,74.9307958477509,64.2,67.7543252595156
19746,73,5,6,78,78.3659223118784,77,77.3612310001877,74.4285714285714,74.77773905584
18730,63,12,3,75,77.7210884353741,84,87.0476190476191,79.5,82.3843537414966
18672,39,5,2,44,44.7232084155161,47,47.7725180802104,42.3333333333333,43.029147490686
18580,55,7,10,62,63.0042975206612,59,59.9557024793388,56.9090909090909,57.8309241172051
21692,47,8,8,55,56.5934812132186,55,56.5934812132186,50.1111111111111,51.5629495498214
21861,47,7,6,54,55.1978270710729,55,56.2200090538705,50,51.1090991398823
22573,71,8,7,79,80.0029756000793,80,81.0156714937512,74.5,75.4458440785558
21728,47,7,4,54,55.1978270710729,57,58.2643730194658,51.2,52.3357175192395
21897,52,9,5,61,62.8272928994083,65,66.9471153846154,58,59.737426035503
22544,64,8,3,72,73.125,77,78.203125,71,72.109375
22297,58,4,4,62,62.294887039239,62,62.294887039239,59.2,59.4815695600476
21654,54,9,6,63,64.75,66,67.8333333333333,59.1428571428571,60.7857142857143
26677,56,5,3,61,61.4862882653061,63,63.5022321428571,58.5,58.9663584183673
25669,32,8,0,40,42.5,48,51,60,63.75
25346,40,12,4,52,56.68,60,65.4,53.2,57.988
26087,54,9,6,63,64.75,66,67.8333333333333,59.1428571428571,60.7857142857143
25804,55,9,7,64,65.7137190082645,66,67.7672727272727,59.5,61.0932231404959
25684,39,9,1,48,50.5562130177515,56,58.9822485207101,57,60.0355029585799
26140,40,3,3,43,43.241875,43,43.241875,40.75,40.97921875
25406,41,7,3,48,49.3991671624033,52,53.5157644259369,46.25,47.5981558596074
25506,34,5,1,39,39.8434256055363,43,43.9299307958478,39,39.8434256055363
25484,45,8,6,53,54.6750617283951,55,56.7382716049383,49,50.5486419753086
25532,42,6,3,48,48.9795918367347,51,52.0408163265306,45.75,46.6836734693878
25465,40,11,2,51,54.856875,60,64.5375,58.3333333333333,62.7447916666667
25617,32,1,2,33,33.0322265625,32,32.03125,32,32.03125
25397,38,8,4,46,48.0387811634349,50,52.2160664819945,43.6,45.5324099722992
25288,38,14,4,52,59.0581717451524,62,70.415512465374,56.2,63.8282548476454
25329,38,5,9,43,43.744459833795,39,39.6752077562327,39,39.6752077562327
25421,36,7,2,43,44.6257716049383,48,49.8148148148148,43,44.6257716049383
25340,35,10,2,45,48.6734693877551,53,57.3265306122449,50,54.0816326530612
25413,27,4,2,31,31.6803840877915,33,33.7242798353909,29,29.636488340192
25253,31,9,3,40,43.3714880332986,46,49.8772112382934,40,43.3714880332986
25474,30,3,5,33,33.33,31,31.31,30.5,30.805
25364,28,3,2,31,31.3558673469388,32,32.3673469387755,29,29.3329081632653
25356,26,4,3,30,30.7100591715976,31,31.7337278106509,27.5,28.1508875739645
25382,34,4,5,38,38.5259515570934,37,37.5121107266436,35,35.4844290657439
25672,26,4,4,30,30.7100591715976,30,30.7100591715976,27.2,27.8437869822485
25428,38,5,6,43,43.744459833795,42,42.7271468144044,39.4285714285714,40.1111990502572
26179,51,3,4,54,54.1868512110727,53,53.1833910034602,51.6,51.7785467128028
25638,34,3,4,37,37.288062283737,36,36.280276816609,34.6,34.8693771626298
25772,48,4,5,52,52.3611111111111,51,51.3541666666667,49,49.3402777777778
26339,52,6,4,58,58.7721893491124,60,60.7988165680473,55,55.7322485207101
25565,41,3,7,44,44.2355740630577,40,40.2141582391434,41.375,41.5965199286139
25403,36,10,4,46,49.5493827160494,52,56.0123456790124,45,48.4722222222222
25837,45,6,3,51,51.9066666666667,54,54.96,48.75,49.6166666666667
25482,37,7,4,44,45.5748721694668,47,48.682249817385,41.2,42.6746530314098
25894,47,4,5,51,51.3693979176098,50,50.3621548211861,48,48.3476686283386
25633,44,5,10,49,49.6327479338843,44,44.5681818181818,44.9090909090909,45.4890120210368
25267,33,13,4,46,53.1386593204775,55,63.5353535353535,48.6,56.1421487603306
25474,33,4,4,37,37.5436179981635,37,37.5436179981635,34.2,34.702479338843
25422,38,7,4,45,46.5270083102493,48,49.6288088642659,42.2,43.6319944598338
25511,32,9,4,41,44.2431640625,46,49.638671875,39.2,42.30078125
25450,27,5,4,32,33.0973936899863,33,34.1316872427984,29,29.9945130315501
25410,32,6,5,38,39.3359375,39,40.37109375,34.5,35.712890625
25374,29,5,4,34,35.0107015457788,35,36.0404280618312,31,31.9215219976219
25411,32,4,2,36,36.5625,38,38.59375,34,34.53125
25318,20,4,3,24,24.96,25,26,21.5,22.36
25386,26,9,0,35,39.1937869822485,44,49.2721893491124,62,69.4289940828402
25475,28,5,4,33,34.0522959183673,34,35.0841836734694,30,30.9566326530612
25491,39,9,2,48,50.5562130177515,55,57.9289940828402,51,53.7159763313609
25373,30,3,6,33,33.33,30,30.3,30.4285714285714,30.7328571428571
25336,27,3,3,30,30.3703703703704,30,30.3703703703704,27.75,28.0925925925926
25302,23,2,5,25,25.1890359168242,22,22.1663516068053,23.1666666666667,23.3418399495904
26054,54,4,3,58,58.318244170096,59,59.323731138546,55.5,55.8045267489712
25528,43,8,3,51,52.7652785289346,56,57.9383450513791,50,51.7306652244457
25508,38,5,7,43,43.744459833795,41,41.7098337950139,39.25,39.9295360110803
25411,23,2,1,25,25.1890359168242,26,26.1965973534972,23.5,23.6776937618147
25523,34,3,2,37,37.288062283737,38,38.2958477508651,35,35.272491349481
25441,27,4,4,31,31.6803840877915,31,31.6803840877915,28.2,28.8189300411523
25381,19,7,1,26,29.5290858725762,32,36.3434903047091,29.5,33.5041551246537
25467,29,1,2,30,30.0356718192628,29,29.0344827586207,29,29.0344827586207
25782,37,5,6,42,42.7669831994156,41,41.7487216946676,38.4285714285714,39.1303349681728
25407,16,1,1,17,17.06640625,17,17.06640625,16,16.0625
25765,22,1,0,23,23.047520661157,24,24.0495867768595,22,22.0454545454545
25427,16,0,1,16,16,15,15,16,16
27509,44,10,1,54,56.7892561983471,63,66.254132231405,66.5,69.9349173553719
27676,48,7,3,55,56.1697048611111,59,60.2547743055556,53.25,54.3824869791667
27315,44,9,5,53,55.2174586776859,57,59.3848140495868,50,52.0919421487603
27828,51,7,3,58,59.0926566705113,62,63.1680123029604,56.25,57.3096885813149
27507,44,6,3,50,50.9297520661157,53,53.9855371900827,47.75,48.6379132231405
27782,56,7,7,63,63.984375,63,63.984375,58.625,59.541015625
27835,59,9,1,68,69.5823039356507,76,77.7684573398449,77,78.7917265153691
27358,36,5,3,41,41.7908950617284,43,43.829475308642,38.5,39.2426697530864
27291,51,14,12,65,69.8981161091888,67,72.0488273740869,58,62.3706266820454
27502,55,12,4,67,70.1894214876033,75,78.5702479338843,68.2,71.4465454545455
27529,48,12,1,60,63.75,71,75.4375,81,86.0625
27761,59,7,7,66,66.9290433783396,66,66.9290433783396,61.625,62.4924590634875
27661,45,6,3,51,51.9066666666667,54,54.96,48.75,49.6166666666667
27668,46,5,7,51,51.6025519848771,49,49.5789224952741,47.25,47.8082466918715
27627,48,7,5,55,56.1697048611111,57,58.2122395833333,51.5,52.5952690972222
27699,64,13,10,77,80.177001953125,80,83.30078125,71.0909090909091,74.0241033380682
27919,56,3,7,59,59.1693239795918,55,55.1578443877551,56.375,56.536790497449
27510,50,5,3,55,55.55,57,57.57,52.5,53.025
27601,53,7,4,60,61.0466358134567,63,64.0989676041296,57.2,58.1977928088288
27450,51,5,7,56,56.5382545174933,54,54.5190311418685,52.25,52.7522106881968
27650,52,5,8,57,57.5269970414201,54,54.4992603550296,53.1111111111111,53.6021531886917
27599,49,2,4,51,51.0849645980841,49,49.0816326530612,49.2,49.2819658475635
27967,66,11,10,77,79.1388888888889,78,80.1666666666667,71,72.9722222222222
28040,58,7,3,65,65.9467895362664,69,70.0050535077289,63.25,64.1712990487515
27763,53,4,2,57,57.3246707013172,59,59.3360626557494,55,55.313278746885
27617,58,7,7,65,65.9467895362664,65,65.9467895362664,60.625,61.5080633174792
27884,64,9,6,73,74.443603515625,76,77.5029296875,69.1428571428571,70.5101841517857
27691,54,8,5,62,63.360768175583,65,66.4266117969822,58.6666666666667,59.9542752629172
27780,61,5,6,66,66.4434291857028,65,65.436710561677,62.4285714285714,62.8480055284678
27596,47,6,3,53,53.8637392485287,56,56.9126301493889,50.75,51.5770710728837
27592,54,4,4,58,58.318244170096,58,58.318244170096,55.2,55.5028806584362
27799,50,8,2,58,59.4848,64,65.6384,59.3333333333333,60.8522666666667
27673,55,6,5,61,61.7259504132231,62,62.7378512396694,57.5,58.1842975206612
27809,57,6,3,63,63.6980609418282,66,66.7313019390582,60.75,61.4231301939058
27718,46,9,3,55,57.1053875236295,61,63.3350661625709,55,57.1053875236295
27653,55,11,7,66,68.64,70,72.8,61.875,64.35
28005,53,5,3,58,58.5161979352083,60,60.5339978640085,55.5,55.9939480242079
27635,56,8,5,64,65.3061224489796,67,68.3673469387755,60.6666666666667,61.9047619047619
27451,38,5,6,43,43.744459833795,42,42.7271468144044,39.4285714285714,40.1111990502572
27660,50,10,2,60,62.4,68,70.72,65,67.6
27528,45,9,3,54,56.16,60,62.4,54,56.16
27609,38,8,3,46,48.0387811634349,51,53.2603878116344,45,46.994459833795
27645,36,6,6,42,43.1666666666667,42,43.1666666666667,38.1428571428571,39.2023809523809
27771,42,5,3,47,47.6660997732426,49,49.6944444444444,44.5,45.1306689342404
28000,59,11,6,70,72.4332088480322,75,77.6070094800345,66.8571428571429,69.1811055936307
27902,46,4,3,50,50.3780718336484,51,51.3856332703214,47.5,47.859168241966
27862,43,4,6,47,47.4067063277447,45,45.3893996755003,43.8571428571429,44.2366530170749
27980,50,5,8,55,55.55,52,52.52,51.1111111111111,51.6222222222222
27708,47,9,5,56,58.0534178361249,60,62.2000905387053,53,54.9434133091897
27725,42,6,4,48,48.9795918367347,50,51.0204081632653,45,45.9183673469388
27683,47,8,8,55,56.5934812132186,55,56.5934812132186,50.1111111111111,51.5629495498214
28100,62,9,9,71,72.4960978147763,71,72.4960978147763,65.6,66.9823100936524
28093,62,4,8,66,66.2747138397503,62,62.258064516129,62.6666666666667,62.9275060700659
27949,51,5,3,56,56.5382545174933,58,58.557477893118,53.5,54.0142252979623
27966,45,7,6,52,53.2582716049383,53,54.2824691358025,48,49.1614814814815
27912,50,12,1,62,65.5712,73,77.2048,83,87.7808
27689,50,11,5,61,63.9524,67,70.2428,59.1666666666667,62.0303333333333
33977,65,10,11,75,76.7751479289941,74,75.7514792899408,68.75,70.3772189349112
33434,47,10,5,57,59.5803531009507,62,64.8066998641919,54.5,56.96717971933
33324,36,6,4,42,43.1666666666667,44,45.2222222222222,39,40.0833333333333
33570,57,11,7,68,70.5324715297015,72,74.6814404432133,63.875,66.2538473376424
33473,42,10,3,52,54.9478458049887,59,62.3446712018141,53.25,56.2687074829932
33300,32,11,3,43,48.0810546875,51,57.0263671875,45.75,51.156005859375
33926,59,11,6,70,72.4332088480322,75,77.6070094800345,66.8571428571429,69.1811055936307
33497,38,3,2,41,41.255540166205,42,42.2617728531856,39,39.2430747922438
33204,42,18,8,60,71.0204081632653,70,82.8571428571429,59,69.8367346938775
33925,51,8,6,59,60.4517493271819,61,62.5009611687812,55,56.3533256439831
33637,27,4,4,31,31.6803840877915,31,31.6803840877915,28.2,28.8189300411523
33451,49,9,3,58,59.9566847147022,64,66.1591003748438,58,59.9566847147022
33514,55,13,4,68,71.7990082644628,77,81.3018181818182,70.6,74.5442644628099
33565,27,6,2,33,34.6296296296296,37,38.8271604938272,32,33.5802469135802
33383,22,4,1,26,26.8595041322314,29,29.9586776859504,25,25.8264462809917
33989,28,4,1,32,32.6530612244898,35,35.7142857142857,31,31.6326530612245
33381,54,11,7,65,67.6971879286694,69,71.8631687242798,60.875,63.4010202331962
33845,62,10,6,72,73.8730489073881,76,77.9771071800208,68.4285714285714,70.2087111639661
33546,25,4,2,29,29.7424,31,31.7936,27,27.6912
33344,56,15,10,71,76.094068877551,76,81.452806122449,65.5454545454545,70.2481737012987
33738,53,5,5,58,58.5161979352083,58,58.5161979352083,54.6666666666667,55.1531980538744
33589,39,7,2,46,47.4819197896121,51,52.6429980276134,46,47.4819197896121
34014,33,3,2,36,36.297520661157,37,37.3057851239669,34,34.2809917355372
33475,28,5,3,33,34.0522959183673,35,36.1160714285714,30.5,31.4725765306122
33488,32,4,9,36,36.5625,31,31.484375,32.6,33.109375
33960,56,8,7,64,65.3061224489796,65,66.3265306122449,59.5,60.7142857142857
33412,42,13,6,55,60.2692743764172,62,67.9399092970522,53.1428571428571,58.2342079689018
33404,41,17,5,58,67.9714455681142,70,82.034503271862,63.6666666666667,74.6123339282173
33445,28,5,4,33,34.0522959183673,34,35.0841836734694,30,30.9566326530612
33971,40,2,7,42,42.105,37,37.0925,40.125,40.2253125
33386,36,9,8,45,47.8125,46,48.875,40,42.5
33735,34,6,5,40,41.2456747404844,41,42.2768166089965,36.5,37.636678200692
33534,30,8,2,38,40.7022222222222,44,47.1288888888889,39.3333333333333,42.1303703703704
33618,40,8,5,48,49.92,51,53.04,44.6666666666667,46.4533333333333
33854,41,6,4,47,48.0065437239738,49,50.0493753718025,44,44.9422962522308
33555,12,1,1,13,13.0902777777778,13,13.0902777777778,12,12.0833333333333
34114,30,2,0,32,32.1422222222222,34,34.1511111111111,31,31.1377777777778
33941,38,10,3,48,51.3240997229917,55,58.808864265928,49.25,52.6606648199446
33606,20,3,2,23,23.5175,24,24.54,21,21.4725
33812,38,6,5,44,45.0969529085873,45,46.1218836565097,40.5,41.5096952908587
33732,29,3,3,32,32.3424494649227,32,32.3424494649227,29.75,30.0683709869203
33947,35,6,2,41,42.2048979591837,45,46.3224489795918,40,41.1755102040816
35360,51,5,5,56,56.5382545174933,56,56.5382545174933,52.6666666666667,53.1728822247853
34979,61,12,6,73,75.8250470303682,79,82.0572426766998,70.4285714285714,73.1541060390832
35285,49,10,7,59,61.457309454394,62,64.582257392753,54.625,56.9000937109538
34513,38,8,6,46,48.0387811634349,48,50.1274238227147,42,43.8614958448753
35490,64,12,6,76,78.671875,82,84.8828125,73.4285714285714,76.0100446428571
34726,39,13,5,52,57.7777777777778,60,66.6666666666667,52,57.7777777777778
35598,34,2,3,36,36.1245674740484,35,35.121107266436,34.25,34.3685121107266
35209,50,8,6,58,59.4848,60,61.536,54,55.3824
34601,27,3,3,30,30.3703703703704,30,30.3703703703704,27.75,28.0925925925926
34968,51,13,2,64,68.158400615148,75,79.8731257208766,77,82.0030757401
35211,45,7,5,52,53.2582716049383,54,55.3066666666667,48.5,49.6735802469136
34787,54,10,5,64,66.1947873799726,69,71.3662551440329,61.5,63.6090534979424
34723,48,9,7,57,59.00390625,59,61.07421875,52.5,54.345703125
34912,56,9,7,65,66.6788903061224,67,68.7305484693877,60.5,62.0626594387755
34793,50,15,3,65,70.85,77,83.93,76.25,83.1125
34435,31,8,3,39,41.5972944849116,44,46.9302809573361,38,40.5306971904266
35061,52,9,8,61,62.8272928994083,62,63.8572485207101,56,57.6775147928994
34879,52,9,8,61,62.8272928994083,62,63.8572485207101,56,57.6775147928994
34659,37,7,4,44,45.5748721694668,47,48.682249817385,41.2,42.6746530314098
35401,39,9,2,48,50.5562130177515,55,57.9289940828402,51,53.7159763313609
34944,33,8,4,41,43.4095500459137,45,47.6446280991736,38.6,40.8685032139578
34920,37,10,4,47,50.4331628926224,53,56.8714390065741,46,49.3601168736304
35181,46,9,8,55,57.1053875236295,56,58.1436672967864,50,51.913988657845
34725,51,7,7,58,59.0926566705113,58,59.0926566705113,53.625,54.6352364475202
34627,56,11,11,67,69.5851403061225,67,69.5851403061225,60.5833333333333,62.9208917942177
34588,42,11,6,53,56.6354875283447,58,61.9784580498866,49.8571428571429,53.277048914804
34728,33,7,6,40,41.7998163452709,41,42.8448117539027,36,37.6198347107438
35048,48,9,4,57,59.00390625,62,64.1796875,55.2,57.140625
34568,31,5,2,36,36.9365244536941,39,40.0145681581686,34.3333333333333,35.2265001734305
34988,63,9,7,72,73.469387755102,74,75.5102040816327,67.5,68.8775510204082
34937,40,14,4,54,60.615,64,71.84,58.2,65.3295
35329,57,8,4,65,66.2803939673746,69,70.3591874422899,62.6,63.8331178824254
35362,68,10,7,78,79.6868512110727,81,82.7517301038062,73.625,75.2172361591696
34929,71,16,9,87,91.4181709978179,94,98.7736560206308,83,87.2150366990677
36535,60,12,5,72,74.88,79,82.16,71,73.84
35196,63,11,3,74,76.2559838750315,82,84.4998740236835,76.75,79.0898211136306
37281,62,10,8,72,73.8730489073881,74,75.9250780437045,67,68.7429760665973
34752,54,8,14,62,63.360768175583,56,57.2290809327846,55.8666666666667,57.092821216278
35426,52,5,6,57,57.5269970414201,56,56.5177514792899,53.4285714285714,53.9225486052409
34869,63,9,12,72,73.469387755102,69,70.4081632653061,65.7692307692308,67.1114599686028
35174,59,13,9,72,75.4955472565355,76,79.689744326343,66.8,70.0430910657857
34604,59,11,9,70,72.4332088480322,72,74.5027291008331,64.5,66.7420281528296
34770,56,9,4,65,66.6788903061224,70,71.8080357142857,63.2,64.8323979591837
34830,59,5,7,64,64.4596380350474,62,62.4452743464522,60.25,60.6827061189313
34679,52,10,3,62,64.292899408284,69,71.551775147929,63.25,65.5891272189349
34890,62,9,2,71,72.4960978147763,78,79.6436004162331,74,75.5593132154006
34738,53,11,6,64,66.7568529725881,69,71.9722321110715,60.8571428571429,63.4786146569699
34971,49,8,4,57,58.5193669304456,61,62.6259891711787,54.6,56.0553935860058
34800,49,9,4,58,59.9566847147022,63,65.1253644314869,56.2,58.0959600166597
34638,47,11,4,58,61.1770031688547,65,68.5604345857854,58,61.1770031688547
34908,45,7,8,52,53.2582716049383,51,52.2340740740741,47.3333333333333,48.478683127572
34656,57,20,5,77,86.4798399507541,92,103.326562019083,88.6666666666667,99.5828460038986
34645,56,15,6,71,76.094068877551,80,85.7397959183673,71,76.094068877551
34861,49,14,8,63,68.1428571428572,69,74.6326530612245,59.1111111111111,63.9365079365079
35434,58,4,5,62,62.294887039239,61,61.2901307966706,59,59.2806183115339
34675,44,12,5,56,60.1652892561983,63,67.6859504132231,55,59.0909090909091
35020,49,9,6,58,59.9566847147022,61,63.057892544773,54.1428571428571,55.9694175046112
34826,54,7,5,61,62.0250342935528,63,64.0586419753086,57.5,58.4662208504801
35484,40,12,8,52,56.68,56,61.04,47.3333333333333,51.5933333333333
34692,57,10,9,67,69.0621729763004,68,70.0929516774392,61.5,63.3928901200369
34937,65,6,4,71,71.6049704142012,73,73.6220118343195,68,68.5794082840237
34536,53,6,8,59,59.7561409754361,57,57.7305090779637,54.6666666666667,55.3672718642459
34956,59,12,7,71,73.9370870439529,76,79.1439241597242,67.25,70.0319592071244
35356,61,9,5,70,71.5237839290513,74,75.6108572964257,67,68.4584789035206
35764,65,10,7,75,76.7751479289941,78,79.8461538461538,70.625,72.2965976331361
35024,50,10,6,60,62.4,64,66.56,56.4285714285714,58.6857142857143
35186,40,4,2,44,44.44,46,46.46,42,42.42
35160,46,10,7,56,58.6465028355388,59,61.7882797731569,51.625,54.0647448015123
35269,56,9,10,65,66.6788903061224,64,65.6530612244898,59.2727272727273,60.8036873840445
35177,39,5,8,44,44.7232084155161,41,41.6738987508218,40.1111111111111,40.7703995909124
35668,45,9,5,54,56.16,58,60.32,51,53.04
35168,66,11,6,77,79.1388888888889,82,84.2777777777778,73.8571428571429,75.9087301587302
35016,53,8,7,61,62.3898184407262,62,63.4126023495906,56.5,57.7872908508366
34983,50,15,7,65,70.85,73,79.57,63.125,68.80625
36081,72,14,7,86,89.2515432098765,93,96.5162037037037,83.375,86.5272955246914
35659,62,7,9,69,69.8795525494277,67,67.8540582726327,64.1,64.9170915712799
35364,59,7,5,66,66.9290433783396,68,68.9571962079862,62.5,63.3797759264579
35049,55,9,5,64,65.7137190082645,68,69.820826446281,61,62.6333884297521
35998,53,8,6,61,62.3898184407262,63,64.435386258455,57,58.2986828052688
35919,49,7,5,56,57.1428571428571,58,59.1836734693878,52.5,53.5714285714286
36028,53,4,8,57,57.3246707013172,53,53.3018867924528,53.6666666666667,53.9723507772636
35563,42,10,6,52,54.9478458049887,56,59.1746031746032,48.4285714285714,51.1739552964043
35910,58,9,7,67,68.6132580261593,69,70.6614149821641,62.5,64.0049048751486
36047,54,10,11,64,66.1947873799726,63,65.1604938271605,57.75,59.7304526748971
35945,49,9,7,58,59.9566847147022,60,62.0241566014161,53.5,55.304872969596
36040,53,8,7,61,62.3898184407262,62,63.4126023495906,56.5,57.7872908508366
36080,65,7,12,72,72.8350295857988,67,67.7770414201184,66.6153846153846,67.3879654073737
36145,59,10,9,69,70.9821890261419,70,72.0109164033324,63.5,65.3241884515944
35566,42,7,8,49,50.3611111111111,48,49.3333333333333,44.3333333333333,45.5648148148148
35734,62,10,7,72,73.8730489073881,75,76.9510926118626,67.625,69.3842351716961
35922,56,7,9,63,63.984375,61,61.953125,58.1,59.0078125
35541,62,4,5,66,66.2747138397503,65,65.2705515088449,63,63.2622268470343
36437,63,3,9,66,66.1496598639456,60,60.1360544217687,63.3,63.443537414966
36116,48,5,8,53,53.5750868055556,50,50.5425347222222,49.1111111111111,49.6440007716049
35953,60,9,9,69,70.5525,69,70.5525,63.6,65.031
36146,75,8,6,83,83.9443555555555,85,85.9671111111111,79,79.8988444444444
36151,74,8,11,82,82.9583637691746,79,79.9233016800584,76.3333333333333,77.2254687119552
35948,77,11,4,88,89.7959183673469,95,96.9387755102041,88,89.7959183673469
35608,60,4,5,64,64.2844444444444,63,63.28,61,61.2711111111111
36456,63,7,13,70,70.8641975308642,64,64.7901234567901,64.5,65.2962962962963
35931,58,9,5,67,68.6132580261593,71,72.7095719381688,64,65.5410225921522
36347,43,7,4,50,51.3250405624662,53,54.4045429962142,47.2,48.4508382909681
35936,38,14,3,52,59.0581717451524,63,71.5512465373961,60.75,68.9958448753463
35624,39,10,5,49,52.2215647600263,54,57.5502958579882,46.5,49.5571992110454
35898,48,7,5,55,56.1697048611111,57,58.2122395833333,51.5,52.5952690972222
35997,43,4,10,47,47.4067063277447,41,41.3547863710114,43.5454545454545,43.922267564777
36101,49,9,4,58,59.9566847147022,63,65.1253644314869,56.2,58.0959600166597
35807,41,13,2,54,59.4289113622844,65,71.5348007138608,67,73.7358715050565
36589,56,8,7,64,65.3061224489796,65,66.3265306122449,59.5,60.7142857142857
36221,64,5,9,69,69.421142578125,65,65.396728515625,65,65.396728515625
36022,63,7,5,70,70.8641975308642,72,72.8888888888889,66.5,67.320987654321
36402,59,16,5,75,80.5156564205688,86,92.3246193622522,79,84.8098247629991
36946,67,20,4,87,94.7522833593228,103,112.177990643796,105,114.356204054355
36911,61,11,3,72,74.3413061005106,80,82.6014512227896,74.75,77.180730986294
36970,56,7,6,63,63.984375,64,65,59,59.921875
36518,48,9,8,57,59.00390625,58,60.0390625,52,53.828125
36877,44,11,4,55,58.4375,62,65.875,55,58.4375
36628,51,6,8,57,57.7889273356401,55,55.7612456747405,52.6666666666667,53.3956170703576
37108,52,8,6,60,61.4201183431953,62,63.4674556213018,56,57.3254437869822
36576,37,3,3,40,40.2629656683711,40,40.2629656683711,37.75,37.9981738495252
37386,62,10,6,72,73.8730489073881,76,77.9771071800208,68.4285714285714,70.2087111639661
37138,52,13,4,65,69.0625,74,78.625,67.6,71.825
36585,49,7,4,56,57.1428571428571,59,60.2040816326531,53.2,54.2857142857143
36519,35,7,2,42,43.68,47,48.88,42,43.68
36878,47,8,3,55,56.5934812132186,60,61.7383431416931,54,55.5645088275238
36968,52,5,10,57,57.5269970414201,52,52.4807692307692,52.9090909090909,53.3982651963421
36918,35,5,3,40,40.8163265306122,42,42.8571428571429,37.5,38.265306122449
37241,44,6,4,50,50.9297520661157,52,52.9669421487603,47,47.8739669421488
37041,54,8,3,62,63.360768175583,67,68.4705075445816,61,62.3388203017833
37109,63,7,6,70,70.8641975308642,71,71.8765432098765,66,66.8148148148148
36926,48,9,6,57,59.00390625,60,62.109375,53.1428571428571,55.0111607142857
36468,33,6,4,39,40.2892561983471,41,42.3553719008264,36,37.1900826446281
36850,38,5,1,43,43.744459833795,47,47.8137119113573,43,43.744459833795
37162,57,7,11,64,64.9652200677131,60,60.9048938134811,58.75,59.6360418590336
36542,35,10,5,45,48.6734693877551,50,54.0816326530612,42.5,45.969387755102
36476,30,5,5,35,35.9722222222222,35,35.9722222222222,31.6666666666667,32.5462962962963
36860,32,4,5,36,36.5625,35,35.546875,33,33.515625
38551,43,8,5,51,52.7652785289346,54,55.8691184424013,47.6666666666667,49.3165675139715
38647,52,9,3,61,62.8272928994083,67,69.0070266272189,61,62.8272928994083
38506,35,5,5,40,40.8163265306122,40,40.8163265306122,36.6666666666667,37.4149659863946
38972,53,5,6,58,58.5161979352083,57,57.5072979708081,54.4285714285714,54.9129837766363
38969,49,6,9,55,55.8246563931695,52,52.7796751353603,50.5,51.2571845064556
38449,37,3,9,40,40.2629656683711,34,34.2235208181154,37.3,37.545215485756
38736,46,4,4,50,50.3780718336484,50,50.3780718336484,47.2,47.5568998109641
38632,41,7,6,48,49.3991671624033,49,50.4283164782867,44,45.2825698988697
38464,25,3,1,28,28.4032,30,30.432,26.5,26.8816
38610,56,10,7,66,68.1045918367347,69,71.2002551020408,61.625,63.5900829081633
38673,55,4,6,59,59.3120661157025,57,57.3014876033058,55.8571428571429,56.152585596222
38793,51,6,5,57,57.7889273356401,58,58.80276816609,53.5,54.2404844290657
39123,58,9,5,67,68.6132580261593,71,72.7095719381688,64,65.5410225921522
38335,44,8,6,52,53.7190082644628,54,55.7851239669421,48,49.5867768595041
38853,52,3,6,55,55.1830621301775,52,52.1730769230769,52.4285714285714,52.6030748098056
39106,42,6,4,48,48.9795918367347,50,51.0204081632653,45,45.9183673469388
40236,55,4,2,59,59.3120661157025,61,61.3226446280992,57,57.3014876033058
38961,50,9,10,59,60.9116,58,59.8792,53.2727272727273,54.9987636363636
38886,31,6,1,37,38.3860561914672,42,43.573361082206,38.5,39.9422476586889
38648,20,5,2,25,26.5625,28,29.75,23.3333333333333,24.7916666666667
38924,36,5,4,41,41.7908950617284,42,42.8101851851852,38,38.733024691358
38725,59,9,9,68,69.5823039356507,68,69.5823039356507,62.6,64.0566503878196
38638,55,8,10,63,64.3328925619835,61,62.2905785123967,57.5454545454545,58.7629451540195
38656,44,8,4,52,53.7190082644628,56,57.8512396694215,49.6,51.2396694214876
38787,61,6,8,67,67.6482128460091,65,65.6288632088148,62.6666666666667,63.2729552987548
38691,48,7,5,55,56.1697048611111,57,58.2122395833333,51.5,52.5952690972222
39084,49,5,5,54,54.5622657226156,54,54.5622657226156,50.6666666666667,51.194224628627
40397,57,3,5,60,60.1662049861496,58,58.1606648199446,57.5,57.6592797783933
39028,49,7,6,56,57.1428571428571,57,58.1632653061224,52,53.0612244897959
38741,36,5,4,41,41.7908950617284,42,42.8101851851852,38,38.733024691358
38794,25,1,3,26,26.0416,24,24.0384,25,25.04
38733,27,4,1,31,31.6803840877915,34,34.7462277091907,30,30.6584362139918
38532,40,7,2,47,48.439375,52,53.5925,47,48.439375
38804,42,9,7,51,53.3418367346939,53,55.4336734693878,46.5,48.6352040816327
39134,60,8,9,68,69.2088888888889,67,68.1911111111111,62.8,63.9164444444444
39417,50,10,7,60,62.4,63,65.52,55.625,57.85
38812,43,8,6,51,52.7652785289346,53,54.8345051379124,47,48.6268253109789
39239,39,7,2,46,47.4819197896121,51,52.6429980276134,46,47.4819197896121
39151,34,7,1,41,42.7378892733564,47,48.992214532872,44.5,46.3862456747405
38886,23,5,0,28,29.3232514177694,33,34.5595463137996,33,34.5595463137996
39837,65,8,6,73,74.105798816568,75,76.1360946745562,69,70.0452071005917
38809,56,9,10,65,66.6788903061224,64,65.6530612244898,59.2727272727273,60.8036873840445
39223,54,7,6,61,62.0250342935528,62,63.0418381344307,57,57.9578189300412
39144,43,4,3,47,47.4067063277447,48,48.415359653867,44.5,44.8850730124392
39081,36,6,4,42,43.1666666666667,44,45.2222222222222,39,40.0833333333333
39264,43,4,6,47,47.4067063277447,45,45.3893996755003,43.8571428571429,44.2366530170749
39183,20,4,1,24,24.96,27,28.08,23,23.92
38806,21,4,1,25,25.907029478458,28,29.015873015873,24,24.8707482993197
38970,62,15,5,77,81.5070239334027,87,92.0923517169615,79.5,84.1533558792924
38964,64,12,11,76,78.671875,77,79.70703125,69.5,71.943359375
39214,54,7,2,61,62.0250342935528,66,67.1090534979424,61,62.0250342935528
39113,32,6,5,38,39.3359375,39,40.37109375,34.5,35.712890625
38992,29,6,5,35,36.4982164090369,36,37.5410225921522,31.5,32.8483947681332
39358,49,13,4,62,66.3640149937526,71,75.9975010412328,64.6,69.1470220741358
40678,67,2,3,69,69.0614836266429,68,68.0605925595901,67.25,67.3099242593005
39484,55,16,7,71,77.0085950413223,80,86.7702479338843,70,75.9239669421488
40343,56,6,6,62,62.7117346938776,62,62.7117346938776,58.1428571428571,58.8103134110787
39892,63,12,3,75,77.7210884353741,84,87.0476190476191,79.5,82.3843537414966
39870,60,12,6,72,74.88,78,81.12,69.4285714285714,72.2057142857143
40446,57,10,5,67,69.0621729763004,72,74.2160664819945,64.5,66.4852262234534
39836,60,11,6,71,73.3863888888889,76,78.5544444444444,67.8571428571429,70.1378968253968
39699,64,7,7,71,71.849365234375,71,71.849365234375,66.625,67.4220275878906
39854,69,9,9,78,79.3270321361059,78,79.3270321361059,72.6,73.8351606805293
39643,66,7,5,73,73.8211662075298,75,75.8436639118457,69.5,70.281795224977
39950,60,10,3,70,71.9444444444444,77,79.1388888888889,71.25,73.2291666666667
39902,64,7,8,71,71.849365234375,70,70.83740234375,66.3333333333333,67.1268717447917
39918,49,13,6,62,66.3640149937526,69,73.856726364015,60.1428571428571,64.3761527934789
40161,66,6,7,72,72.595041322314,71,71.5867768595041,67.875,68.4359504132231
39894,63,6,4,69,69.6258503401361,71,71.6439909297052,66,66.5986394557823
39896,66,9,10,75,76.3946280991736,74,75.3760330578512,69.2727272727273,70.560856498873
39826,59,12,2,71,73.9370870439529,81,84.3507612754955,81,84.3507612754955
40057,50,10,5,60,62.4,65,67.6,57.5,59.8
40014,68,12,3,80,82.4913494809689,89,91.7716262975779,84.5,87.1314878892734
39770,62,10,5,72,73.8730489073881,77,79.003121748179,69.5,71.3080124869927
39570,48,7,5,55,56.1697048611111,57,58.2122395833333,51.5,52.5952690972222
39769,63,13,1,76,79.236079617032,88,91.7470395565634,102,106.343159486017
40347,61,6,4,67,67.6482128460091,69,69.6675624832034,64,64.6191883902177
39494,52,9,4,61,62.8272928994083,66,67.9770710059172,59.2,60.9733727810651
40392,66,5,5,71,71.4074839302112,71,71.4074839302112,67.6666666666667,68.055019895929
39944,67,10,4,77,78.7153040766318,83,84.8489641345511,76,77.6930274003119
39738,53,7,6,60,61.0466358134567,61,62.064079743681,56,56.9768600925596
39836,66,5,4,71,71.4074839302112,72,72.4132231404959,68,68.3902662993572
40112,70,6,9,76,76.5583673469388,73,73.5363265306123,71.5,72.025306122449
40007,55,5,7,60,60.495867768595,58,58.4793388429752,56.25,56.7148760330578
39979,59,7,3,66,66.9290433783396,70,70.9853490376329,64.25,65.1544096523987
39773,57,5,7,62,62.4770698676516,60,60.4616805170822,58.25,58.6982148353339
40456,56,3,4,59,59.1693239795918,58,58.1664540816327,56.6,56.7624362244898
39615,63,8,10,71,72.1448727639204,69,70.1126228269085,65.5454545454545,66.6023729357063
39788,66,12,5,78,80.5785123966942,85,87.8099173553719,77,79.5454545454545
42737,37,3,5,40,40.2629656683711,38,38.2498173849525,37.5,37.7465303140979
42780,48,9,4,57,59.00390625,62,64.1796875,55.2,57.140625
42923,54,9,3,63,64.75,69,70.9166666666667,63,64.75
42672,35,3,3,38,38.2791836734694,38,38.2791836734694,35.75,36.0126530612245
42588,54,7,5,61,62.0250342935528,63,64.0586419753086,57.5,58.4662208504801
42515,38,9,2,47,49.6364265927978,54,57.0290858725762,50,52.8047091412742
42745,58,8,4,66,67.2556480380499,70,71.3317479191439,63.6,64.8099881093936
42732,44,13,3,57,61.9757231404959,67,72.8486570247934,63.5,69.0431301652893
42616,43,6,1,49,49.9540292049757,54,55.0513791238507,50.5,51.4832341806382
42410,46,12,6,58,61.9470699432892,64,68.3553875236295,55.4285714285714,59.2006481231434
42455,43,9,7,52,54.2779881016766,54,56.3656030286641,47.5,49.5808545159546
42639,51,7,6,58,59.0926566705113,59,60.1114955786236,54,55.0173010380623
42547,29,6,0,35,36.4982164090369,41,42.7550535077289,44,45.8834720570749
43913,38,2,4,40,40.1108033240997,38,38.1052631578947,38.2,38.3058171745152
42588,51,4,7,55,55.3383314109958,52,52.319876970396,51.75,52.068339100346
42448,25,4,2,29,29.7424,31,31.7936,27,27.6912
42622,50,9,3,59,60.9116,65,67.106,59,60.9116
42753,43,9,7,52,54.2779881016766,54,56.3656030286641,47.5,49.5808545159546
42698,31,4,2,35,35.582726326743,37,37.6160249739854,33,33.5494276795005
42451,42,7,6,49,50.3611111111111,50,51.3888888888889,45,46.25
42660,33,6,4,39,40.2892561983471,41,42.3553719008264,36,37.1900826446281
42665,51,4,8,55,55.3383314109958,51,51.3137254901961,51.6666666666667,51.9844931436627
42621,47,6,10,53,53.8637392485287,49,49.7985513807153,48.3636363636364,49.1518169471995
42451,35,7,4,42,43.68,45,46.8,39.2,40.768
42508,41,6,5,47,48.0065437239738,48,49.0279595478882,43.5,44.4315883402736
42595,39,10,5,49,52.2215647600263,54,57.5502958579882,46.5,49.5571992110454
42550,42,10,4,52,54.9478458049887,58,61.2879818594104,51,53.891156462585
42475,42,5,10,47,47.6660997732426,42,42.5952380952381,42.9090909090909,43.5172129457844
42396,32,8,5,40,42.5,43,45.6875,36.6666666666667,38.9583333333333
43135,39,5,1,44,44.7232084155161,48,48.7889546351085,44,44.7232084155161
42940,34,4,3,38,38.5259515570934,39,39.5397923875433,35.5,35.9913494809689
43217,26,2,3,28,28.1656804733728,27,27.1597633136095,26.25,26.405325443787
42640,38,6,5,44,45.0969529085873,45,46.1218836565097,40.5,41.5096952908587
42442,34,8,6,42,44.3252595155709,44,46.4359861591695,38,40.1038062283737
42643,43,6,6,49,49.9540292049757,49,49.9540292049757,45.1428571428571,46.0217878389863
42705,39,6,3,45,46.0650887573964,48,49.1360946745562,42.75,43.7618343195266
42495,53,6,9,59,59.7561409754361,56,56.7176931292275,54.5,55.1984692061232
42560,48,8,7,56,57.5555555555556,57,58.5833333333333,51.5,52.9305555555556
42630,42,5,7,47,47.6660997732426,45,45.6377551020408,43.25,43.8629535147392
42542,44,11,4,55,58.4375,62,65.875,55,58.4375
42479,39,7,5,46,47.4819197896121,48,49.5463510848126,42.5,43.8691650230112
42696,19,4,1,23,24.0193905817175,26,27.1523545706371,22,22.9750692520776
42799,44,5,4,49,49.6327479338843,50,50.6456611570248,46,46.5940082644628
42595,37,5,4,42,42.7669831994156,43,43.7852447041636,39,39.7121986851717
42963,50,4,6,54,54.3456,52,52.3328,50.8571428571429,51.1826285714286
42835,48,8,4,56,57.5555555555556,60,61.6666666666667,53.6,55.0888888888889
42803,39,10,4,49,52.2215647600263,55,58.6160420775805,48,51.1558185404339
43139,54,6,5,60,60.7407407407407,61,61.7530864197531,56.5,57.1975308641975
42707,48,9,8,57,59.00390625,58,60.0390625,52,53.828125
42672,43,7,7,50,51.3250405624662,50,51.3250405624662,45.625,46.8340995132504
43352,50,7,2,57,58.1172,62,63.2152,57,58.1172
43321,32,4,4,36,36.5625,36,36.5625,33.2,33.71875
43275,58,6,5,64,64.6848989298454,65,65.6956004756242,60.5,61.1474435196195
42749,44,12,6,56,60.1652892561983,62,66.6115702479339,53.4285714285714,57.4025974025974
43583,30,3,2,33,33.33,34,34.34,31,31.31
43555,47,11,4,58,61.1770031688547,65,68.5604345857854,58,61.1770031688547
43384,39,9,5,48,50.5562130177515,52,54.7692307692308,45,47.396449704142
43328,36,4,8,40,40.4938271604938,36,36.4444444444444,36.6666666666667,37.119341563786
43617,45,12,5,57,61.0533333333333,64,68.5511111111111,56,59.9822222222222
43214,9,2,0,11,11.5432098765432,13,13.641975308642,10,10.4938271604938
43248,14,2,2,16,16.3265306122449,16,16.3265306122449,14.3333333333333,14.6258503401361
44390,45,9,3,54,56.16,60,62.4,54,56.16
44537,55,12,9,67,70.1894214876033,70,73.3322314049587,61.6,64.5323636363636
44418,51,12,9,63,66.4878892733564,66,69.6539792387543,57.6,60.7889273356401
44315,34,4,1,38,38.5259515570934,41,41.5674740484429,37,37.5121107266436
44312,46,15,3,61,67.4862948960302,73,80.7622873345936,72.25,79.9325378071834
44339,59,15,8,74,78.783108302212,81,86.2355644929618,70.6666666666667,75.2343196399502
44534,60,10,6,70,71.9444444444444,74,76.0555555555555,66.4285714285714,68.2738095238095
44248,47,13,10,60,64.5903123585333,63,67.8198279764599,54.0909090909091,58.2291452323141
44546,53,11,4,64,66.7568529725881,71,74.0583837664649,64,66.7568529725881
44734,61,9,7,70,71.5237839290513,72,73.5673206127385,65.5,66.9258263907552
44610,61,10,9,71,72.9080892233271,72,73.9349637194303,65.5,67.2602794947595
44594,53,12,6,65,68.3321466714133,71,74.6397294410822,62.4285714285714,65.6288969129838
44550,60,6,14,66,66.66,58,58.58,61,61.61
44615,55,8,8,63,64.3328925619835,63,64.3328925619835,58.1111111111111,59.3405693296602
44454,53,14,9,67,71.6749733001068,72,77.0238519045924,62.1,66.4330722677109
44521,59,13,10,72,75.4955472565355,75,78.6411950588911,66.0909090909091,69.2995743125016
44310,46,12,3,58,61.9470699432892,67,71.5595463137996,62.5,66.7533081285444
44435,57,9,11,66,67.6454293628809,64,65.595567867036,60,61.4958448753463
44537,63,12,8,75,77.7210884353741,79,81.8662131519274,70.3333333333333,72.8851095993953
44297,45,8,8,53,54.6750617283951,53,54.6750617283951,48.1111111111111,49.6316598079561
44426,53,12,5,65,68.3321466714133,72,75.6909932360271,64,67.2808828764685
44378,52,11,9,63,65.8191568047337,65,67.9086538461538,57.5,60.0730399408284
44411,50,13,7,63,67.2588,69,73.6644,59.75,63.7891
44654,55,8,7,63,64.3328925619835,64,65.3540495867769,58.5,59.7376859504132
44395,51,10,9,61,63.3452518262207,62,64.3836985774702,55.5,57.6337946943483
44391,51,15,8,66,71.7093425605536,73,79.3148788927336,62.6666666666667,68.0876585928489
44372,59,14,12,73,77.1103131284114,75,79.222924446998,66,69.7161735133582
44545,66,14,15,80,83.5996326905418,79,82.55463728191,71.6875,74.9131083562902
44622,53,9,12,62,63.7878248487006,59,60.7013171947312,55.7692307692308,57.3773858750719
44503,49,11,9,60,63.0237401082882,62,65.1245314452312,54.5,57.2465639316951
44362,36,9,6,45,47.8125,48,51,41.1428571428571,43.7142857142857
44419,42,9,7,51,53.3418367346939,53,55.4336734693878,46.5,48.6352040816327
44693,53,7,8,60,61.0466358134567,59,60.0291918832325,55.3333333333333,56.2985641390768
44936,53,11,8,64,66.7568529725881,67,69.8860804556782,59.1111111111111,61.6573711482932
45856,60,7,9,67,67.9119444444444,65,65.8847222222222,62.1,62.94525
45882,43,7,5,50,51.3250405624662,52,53.3780421849648,46.5,47.7322877230936
45812,27,2,2,29,29.159122085048,29,29.159122085048,27.3333333333333,27.4833104709648
45771,51,7,3,58,59.0926566705113,62,63.1680123029604,56.25,57.3096885813149
46404,37,3,3,40,40.2629656683711,40,40.2629656683711,37.75,37.9981738495252
45769,44,7,4,51,52.290805785124,54,55.3667355371901,48.2,49.4199380165289
45707,56,9,2,65,66.6788903061224,72,73.859693877551,68,69.7563775510204
45764,58,6,6,64,64.6848989298454,64,64.6848989298454,60.1428571428571,60.7864786818413
45669,47,7,3,54,55.1978270710729,58,59.2865550022635,52.25,53.409008601177
45517,40,10,5,50,53.125,55,58.4375,47.5,50.46875
46018,49,3,8,52,52.1949187838401,47,47.1761765930862,49.3333333333333,49.5182562821047
45449,42,6,7,48,48.9795918367347,47,47.9591836734694,43.875,44.7704081632653
45618,58,9,4,67,68.6132580261593,72,73.7336504161712,65.2,66.7699167657551
45673,60,14,6,74,78.0288888888889,82,86.4644444444445,73,76.9744444444444
45706,51,8,9,59,60.4517493271819,58,59.4271434063822,53.8,55.1237985390235
45520,40,9,7,49,51.480625,51,53.581875,44.5,46.7528125
45262,37,8,4,45,47.1037253469686,49,51.290723155588,42.6,44.5915266617969
45371,43,7,9,50,51.3250405624662,48,49.2720389399675,45.1,46.2951865873445
45655,69,19,8,88,94.672547784079,99,106.506616257089,88,94.672547784079
45403,48,11,5,59,62.0985243055556,65,68.4136284722222,57.1666666666667,60.1689091435185
45449,36,5,7,41,41.7908950617284,39,39.7523148148148,37.25,37.9685570987654
45424,52,13,6,65,69.0625,72,76.5,63.1428571428571,67.0892857142857
45519,52,7,6,59,60.0691568047337,60,61.0872781065089,55,55.9966715976331
45676,58,11,12,69,71.4818668252081,68,70.4458977407848,62.2307692307692,64.469153022958
45419,42,8,4,50,51.8140589569161,54,55.9591836734694,47.6,49.3269841269841
45472,30,5,0,35,35.9722222222222,40,41.1111111111111,40,41.1111111111111
45401,61,19,11,80,87.7613544746036,88,96.537489922064,75.25,82.550524052674
46192,52,8,3,60,61.4201183431953,65,66.5384615384615,59,60.396449704142
45667,38,6,3,44,45.0969529085873,47,48.1717451523546,41.75,42.7908587257618
45578,52,13,9,65,69.0625,69,73.3125,59.8,63.5375
45812,46,8,2,54,55.6332703213611,60,61.8147448015123,55.3333333333333,57.0069313169502
45950,41,3,6,44,44.2355740630577,41,41.219512195122,41.4285714285714,41.6503781762556
46361,52,9,4,61,62.8272928994083,66,67.9770710059172,59.2,60.9733727810651
45633,56,14,4,70,74.375,80,85,74.2,78.8375
45766,69,14,4,83,86.4169292165512,93,96.8286074354127,87.2,90.789834068473
45874,56,7,5,63,63.984375,65,66.015625,59.5,60.4296875
45567,37,10,8,47,50.4331628926224,49,52.5792549306063,42,45.0679327976625
45996,61,6,3,67,67.6482128460091,70,70.6772373018006,64.75,65.3764445041655
46113,63,12,6,75,77.7210884353741,81,83.9387755102041,72.4285714285714,75.0563654033042
45654,57,12,6,69,72.0581717451524,75,78.3240997229917,66.4285714285714,69.3727740403641
45518,47,13,8,60,64.5903123585333,65,69.972838388411,55.6666666666667,59.9254564659725
45830,65,14,10,79,82.6648520710059,83,86.8504142011834,73.2727272727273,76.6718881118881
45955,42,11,2,53,56.6354875283447,62,66.2528344671202,60.3333333333333,64.4718442932729
45988,56,11,7,67,69.5851403061225,71,73.7394770408163,62.875,65.3009805484694
45790,42,6,4,48,48.9795918367347,50,51.0204081632653,45,45.9183673469388
46298,63,11,8,74,76.2559838750315,77,79.347442680776,69.1111111111111,71.2180510064108
46299,56,9,4,65,66.6788903061224,70,71.8080357142857,63.2,64.8323979591837
45673,50,5,8,55,55.55,52,52.52,51.1111111111111,51.6222222222222
45691,55,11,9,66,68.64,68,70.72,60.5,62.92
45744,52,9,7,61,62.8272928994083,63,64.8872041420118,56.5,58.1924926035503
45896,37,6,1,43,44.1307523739956,48,49.2622352081812,44.5,45.6701972242513
46039,65,13,11,78,81.12,80,83.2,71.5,74.36
46009,55,7,6,62,63.0042975206612,63,64.0204958677686,58,58.9395041322314
45777,49,7,3,56,57.1428571428571,60,61.2244897959184,54.25,55.3571428571429
46178,52,5,7,57,57.5269970414201,55,55.5085059171598,53.25,53.7423261834319
46242,42,6,3,48,48.9795918367347,51,52.0408163265306,45.75,46.6836734693878
45837,48,12,2,60,63.75,70,74.375,70,74.375
46006,63,11,9,74,76.2559838750315,76,78.3169564121945,68.5,70.5883093978332
46281,46,8,3,54,55.6332703213611,59,60.7844990548204,53,54.6030245746692
45976,46,9,5,55,57.1053875236295,59,61.2585066162571,52,53.9905482041588
46489,68,14,14,82,85.4757785467128,82,85.4757785467128,74.0666666666667,77.2061707035755
46627,68,12,10,80,82.4913494809689,82,84.5536332179931,74,76.3044982698962
46658,54,8,6,62,63.360768175583,64,65.4046639231824,58,59.2729766803841
47657,60,9,2,69,70.5525,76,77.71,72,73.62
47054,68,13,3,81,83.9604238754325,91,94.3259083044983,87.5,90.6979887543253
46758,59,7,6,66,66.9290433783396,67,67.9431197931629,62,62.8727377190462
46874,62,10,8,72,73.8730489073881,74,75.9250780437045,67,68.7429760665973
46821,57,7,3,64,64.9652200677131,68,69.0255463219452,62.25,63.1888273314866
46674,37,7,3,44,45.5748721694668,48,49.718042366691,42.25,43.7622352081812
46841,58,7,4,65,65.9467895362664,68,68.9904875148632,62.2,63.1060047562426
47072,54,8,3,62,63.360768175583,67,68.4705075445816,61,62.3388203017833
47177,60,7,5,67,67.9119444444444,69,69.9391666666667,63.5,64.3643055555555
46761,56,11,5,67,69.5851403061225,73,75.8166454081633,65.1666666666667,67.6810693027211
46773,57,12,1,69,72.0581717451524,80,83.5457063711911,90,93.98891966759
46690,56,8,8,64,65.3061224489796,64,65.3061224489796,59.1111111111111,60.3174603174603
46856,60,6,10,66,66.66,62,62.62,61.3636363636364,61.9772727272727
46526,44,5,7,49,49.6327479338843,47,47.6069214876033,45.25,45.8343233471074
46517,51,8,4,59,60.4517493271819,63,64.5501730103806,56.6,57.9926951172626
47105,67,9,5,76,77.3713521942526,80,81.4435286255291,73,74.3172198707953
46796,56,5,4,61,61.4862882653061,62,62.4942602040816,58,58.4623724489796
46804,62,5,12,67,67.4357440166493,60,60.3902185223725,62.7692307692308,63.1774593772513
46662,57,9,6,66,67.6454293628809,69,70.7202216066482,62.1428571428571,63.6921250494658
46682,51,7,5,58,59.0926566705113,60,61.1303344867359,54.5,55.5267204921184
46839,57,11,5,68,70.5324715297015,74,76.7559248999692,66.1666666666667,68.6308607776752
46909,61,3,4,64,64.1547970975544,63,63.1523783929051,61.6,61.7489922063961
47052,52,7,5,59,60.0691568047337,61,62.105399408284,55.5,56.5057322485207
46992,59,9,5,68,69.5823039356507,72,73.6753806377478,65,66.5124964090779
46730,48,9,5,57,59.00390625,61,63.14453125,54,55.8984375
47139,54,7,5,61,62.0250342935528,63,64.0586419753086,57.5,58.4662208504801
46914,53,7,7,60,61.0466358134567,60,61.0466358134567,55.625,56.5953186187255
47241,68,4,6,72,72.2491349480969,70,70.242214532872,68.8571428571429,69.0954028670292
47209,61,5,2,66,66.4434291857028,69,69.4635850577802,64.3333333333333,64.7655648123264
47253,57,9,3,66,67.6454293628809,72,73.7950138504155,66,67.6454293628809
47093,51,7,8,58,59.0926566705113,57,58.0738177623991,53.3333333333333,54.3380750993208
47080,67,4,5,71,71.253063042994,70,70.2494987747828,68,68.2423702383604
46830,57,6,6,63,63.6980609418282,63,63.6980609418282,59.1428571428571,59.7981796596755
46772,58,11,7,69,71.4818668252081,73,75.6257431629013,64.875,67.2084943519619
46620,65,15,4,80,84.2603550295858,91,95.8461538461539,86,90.5798816568047
47051,73,11,6,84,85.9072996809908,89,91.0208294239069,80.8571428571429,82.6930809854435
46890,63,8,3,71,72.1448727639204,76,77.22549760645,70,71.1287477954145
46644,55,11,10,66,68.64,67,69.68,60,62.4
46950,48,6,5,54,54.84375,55,55.859375,50.5,51.2890625
46651,49,9,7,58,59.9566847147022,60,62.0241566014161,53.5,55.304872969596
46852,64,10,6,74,75.806640625,78,79.904296875,70.4285714285714,72.1480189732143
46813,60,8,5,68,69.2088888888889,71,72.2622222222222,64.6666666666667,65.8162962962963
46766,54,4,9,58,58.318244170096,53,53.2908093278464,54.6,54.8995884773663
46899,54,5,5,59,59.5058299039781,59,59.5058299039781,55.6666666666667,56.143918609968
46969,52,10,5,62,64.292899408284,67,69.4778106508876,59.5,61.7004437869822
46701,54,7,5,61,62.0250342935528,63,64.0586419753086,57.5,58.4662208504801
46646,47,11,5,58,61.1770031688547,64,67.505658669081,56.1666666666667,59.2432473215633
47323,67,7,8,74,74.8077522833593,73,73.7968367119626,69.3333333333333,70.0901462835078
47483,39,3,4,42,42.2485207100592,41,41.2426035502959,39.6,39.8343195266272
47838,56,9,8,65,66.6788903061224,66,67.7047193877551,60,61.5497448979592
47465,40,4,7,44,44.44,41,41.41,40.75,41.1575
47951,51,8,4,59,60.4517493271819,63,64.5501730103806,56.6,57.9926951172626
47445,53,18,6,71,79.189391242435,83,92.5735137059452,74.8571428571429,83.4914306057062
47581,50,8,5,58,59.4848,61,62.5616,54.6666666666667,56.0661333333333
47671,51,10,5,61,63.3452518262207,66,68.5374855824683,58.5,60.7491349480969
47486,52,10,4,62,64.292899408284,68,70.5147928994083,61,63.2559171597633
47565,62,8,8,70,71.165452653486,70,71.165452653486,65.1111111111111,66.1951670713377
47610,67,11,4,78,80.1024727110715,85,87.291156159501,78,80.1024727110715
47557,61,9,4,70,71.5237839290513,75,76.6326256382693,68.2,69.6846009137329
47973,67,6,8,73,73.5854310536868,71,71.5693918467365,68.6666666666667,69.2173461052944
47663,61,9,9,70,71.5237839290513,70,71.5237839290513,64.6,66.0062348830959
47619,62,7,11,69,69.8795525494277,65,65.8285639958377,63.75,64.5626300728408
47560,44,10,1,54,56.7892561983471,63,66.254132231405,66.5,69.9349173553719
47643,52,10,6,62,64.292899408284,66,68.4408284023669,58.4285714285714,60.5893913778529
47547,68,18,8,86,92.0259515570934,96,102.726643598616,85,90.9558823529412
49463,54,4,14,58,58.318244170096,48,48.2633744855967,54.4,54.6984910836763
49472,53,10,7,63,65.2427910288359,66,68.3495906016376,58.625,60.7120416518334
49740,70,15,5,85,88.9030612244898,95,99.3622448979592,87.5,91.5178571428571
49577,68,14,9,82,85.4757785467128,87,90.6877162629758,77.1,80.3680795847751
49694,70,13,10,83,85.8626530612245,86,88.9661224489796,77.0909090909091,79.749758812616
49499,67,16,12,83,87.7333481844509,87,91.9614613499666,76.2307692307692,80.5780797505012
49684,59,8,4,67,68.231829933927,71,72.3053720195346,64.6,65.7877046825625
49382,48,10,8,58,60.5173611111111,60,62.6041666666667,53,55.3003472222222
49700,64,9,8,73,74.443603515625,74,75.46337890625,68,69.3447265625
49368,53,10,8,63,65.2427910288359,65,67.313990744037,58,60.064791740833
49393,52,18,8,70,78.387573964497,80,89.585798816568,69,77.2677514792899
49695,76,16,11,92,96.0775623268698,97,101.299168975069,86,89.8116343490305
49450,65,13,8,78,81.12,83,86.32,73.6666666666667,76.6133333333333
50280,58,5,9,63,63.468192627824,59,59.4384661117717,59,59.4384661117717
49935,64,11,3,75,77.215576171875,83,85.451904296875,77.75,80.0468139648438
49762,43,7,6,50,51.3250405624662,51,52.3515413737155,46,47.2190373174689
49575,70,19,13,89,95.5569387755102,95,101.998979591837,82.2142857142857,88.2712973760933
49662,65,15,8,80,84.2603550295858,87,91.6331360946746,76.6666666666667,80.7495069033531
50093,73,12,6,85,87.2968662037906,91,93.4589979358229,82.4285714285714,84.6559526043482
49951,68,8,5,76,77.0519031141869,79,80.0934256055363,72.6666666666667,73.6724336793541
49752,51,12,4,63,66.4878892733564,71,74.9307958477509,64.2,67.7543252595156
50354,59,9,4,68,69.5823039356507,73,74.6986498132721,66.2,67.740419419707
50047,60,8,4,68,69.2088888888889,72,73.28,65.6,66.7662222222222
49923,72,8,4,80,80.9876543209877,84,85.037037037037,77.6,78.558024691358
49802,66,8,7,74,75.0872359963269,75,76.1019283746557,69.5,70.5211202938476
49736,55,8,5,63,64.3328925619835,66,67.3963636363636,59.6666666666667,60.9290358126722
49551,62,15,5,77,81.5070239334027,87,92.0923517169615,79.5,84.1533558792924
50072,56,16,5,72,77.8775510204082,83,89.7755102040816,76,82.2040816326531
49763,56,12,7,68,71.1224489795918,73,76.3520408163265,64.25,67.2002551020408
49906,63,14,5,77,80.8024691358025,86,90.2469135802469,78.1666666666667,82.0267489711934
50132,46,7,5,53,54.2273156899811,55,56.273629489603,49.5,50.6462665406427
49910,61,11,7,72,74.3413061005106,76,78.4713786616501,67.875,70.0821687718355
49854,64,9,6,73,74.443603515625,76,77.5029296875,69.1428571428571,70.5101841517857
49882,51,7,9,58,59.0926566705113,56,57.0549788542868,53.1,54.1003460207613
50284,66,11,5,77,79.1388888888889,83,85.3055555555555,75.1666666666667,77.2546296296296
49689,37,2,6,39,39.1139517896275,35,35.1022644265887,37.1428571428571,37.2513826567881
49528,42,7,6,49,50.3611111111111,50,51.3888888888889,45,46.25
49658,62,8,14,70,71.165452653486,64,65.0655567117586,63.8666666666667,64.9300034686091
49875,66,8,5,74,75.0872359963269,77,78.1313131313131,70.6666666666667,71.7049280685644
49772,51,7,5,58,59.0926566705113,60,61.1303344867359,54.5,55.5267204921184
49915,72,13,11,85,87.7710262345679,87,89.8362268518518,78.5,81.0591242283951
49438,45,10,8,55,57.7160493827161,57,59.8148148148148,50,52.4691358024691
50422,60,5,6,65,65.4513888888889,64,64.4444444444444,61.4285714285714,61.8551587301587
49737,46,9,5,55,57.1053875236295,59,61.2585066162571,52,53.9905482041588
49798,44,10,6,54,56.7892561983471,58,60.995867768595,50.4285714285714,53.0333530106257
50328,73,14,9,87,90.1998498780259,92,95.3837492963032,82.1,85.1196284481141
51328,56,4,6,60,60.3061224489796,58,58.2959183673469,56.8571428571429,57.1472303206997
50659,36,11,5,47,51.3881172839506,53,57.9483024691358,45.1666666666667,49.383616255144
50625,33,3,3,36,36.297520661157,36,36.297520661157,33.75,34.0289256198347
50985,48,5,12,53,53.5750868055556,46,46.4991319444444,48.7692307692308,49.2984107905983
50650,53,9,12,62,63.7878248487006,59,60.7013171947312,55.7692307692308,57.3773858750719
50747,42,8,5,50,51.8140589569161,53,54.9229024943311,46.6666666666667,48.3597883597884
51287,55,7,10,62,63.0042975206612,59,59.9557024793388,56.9090909090909,57.8309241172051
50834,58,13,7,71,74.5668846611177,77,80.8683115338882,67.75,71.1536117717004
50604,44,9,10,53,55.2174586776859,52,54.1756198347107,47.2727272727273,49.2505634861007
50849,62,8,5,70,71.165452653486,73,74.2154006243496,66.6666666666667,67.7766215747485
50696,47,8,5,55,56.5934812132186,58,59.6803983703033,51.6666666666667,53.1635732609024
50627,45,9,6,54,56.16,57,59.28,50.1428571428571,52.1485714285714
50747,58,10,8,68,70.0214030915577,70,72.0808561236623,63,64.8727705112961
50913,34,7,3,41,42.7378892733564,45,46.9074394463668,39.25,40.9137110726644
50550,70,15,7,85,88.9030612244898,93,97.2704081632653,83.125,86.9419642857143
50689,64,13,7,77,80.177001953125,83,86.424560546875,73.75,76.7929077148438
50645,68,11,10,79,81.0672577854671,80,82.0934256055363,73,74.9102508650519
50834,52,7,6,59,60.0691568047337,60,61.0872781065089,55,55.9966715976331
50520,43,7,2,50,51.3250405624662,55,56.4575446187128,50,51.3250405624662
50353,44,15,2,59,65.8569214876033,72,80.3677685950413,79,88.1813016528926
50654,52,10,6,62,64.292899408284,66,68.4408284023669,58.4285714285714,60.5893913778529
50684,53,7,7,60,61.0466358134567,60,61.0466358134567,55.625,56.5953186187255
50717,59,13,6,72,75.4955472565355,79,82.8353921286987,70.1428571428571,73.5482414741248
50351,53,19,1,72,81.25311498754,90,101.566393734425,138.5,156.299394802421
50276,34,7,5,41,42.7378892733564,43,44.8226643598616,37.5,39.0895328719723
50906,50,5,7,55,55.55,53,53.53,51.25,51.7625
50295,49,16,8,65,71.9304456476468,73,80.783423573511,62.3333333333333,68.9794530056921
50565,38,4,6,42,42.4653739612188,40,40.4432132963989,38.8571428571429,39.2876929165018
50965,52,9,5,61,62.8272928994083,65,66.9471153846154,58,59.737426035503
50616,57,13,8,70,73.6411203447214,75,78.9012003693444,65.6666666666667,69.0823843233816
50939,70,7,10,77,77.77,74,74.74,71.9090909090909,72.6281818181818
50507,38,6,4,44,45.0969529085873,46,47.1468144044321,41,42.0221606648199
50870,53,11,3,64,66.7568529725881,72,75.1014595941616,66.75,69.625311498754
50749,52,7,7,59,60.0691568047337,59,60.0691568047337,54.625,55.6148761094675
50707,61,8,7,69,70.1867777479172,70,71.2039774254233,64.5,65.60937919914
50767,53,6,4,59,59.7561409754361,61,61.7817728729085,56,56.7176931292275
51048,52,10,6,62,64.292899408284,66,68.4408284023669,58.4285714285714,60.5893913778529
50916,45,11,7,56,59.3461728395062,60,63.5851851851852,51.875,54.9746913580247
50705,56,7,5,63,63.984375,65,66.015625,59.5,60.4296875
50789,42,5,6,47,47.6660997732426,46,46.6519274376417,43.4285714285714,44.0440557175251
50731,47,14,6,61,66.4124038026256,69,75.1222272521503,60,65.323675871435
50828,56,7,6,63,63.984375,64,65,59,59.921875
50719,58,7,7,65,65.9467895362664,65,65.9467895362664,60.625,61.5080633174792
50515,40,4,3,44,44.44,45,45.45,41.5,41.915
50709,68,15,8,83,87.0387110726644,90,94.3793252595156,79.6666666666667,83.5431805074971
50752,74,17,9,91,95.8025931336742,99,104.224799123448,87.6,92.2231555880204
50852,68,6,7,74,74.5761245674741,73,73.568339100346,69.875,70.4190095155709
51451,66,9,7,75,76.3946280991736,77,78.4318181818182,70.5,71.8109504132232
50541,48,6,3,54,54.84375,57,57.890625,51.75,52.55859375
50794,53,10,5,63,65.2427910288359,68,70.4207903168387,60.5,62.6537913848345
50730,49,12,1,61,64.658475635152,72,76.3182007496876,82,86.9179508538109
51001,42,6,6,48,48.9795918367347,48,48.9795918367347,44.1428571428571,45.0437317784257
50624,57,14,9,71,75.2831640504771,76,80.5847953216374,66.1,70.0875654047399
50975,57,10,4,67,69.0621729763004,73,75.2468451831333,66,68.0313942751616
51101,58,5,7,63,63.468192627824,61,61.4533293697979,59.25,59.690324019025
51083,60,10,7,70,71.9444444444444,73,75.0277777777778,65.625,67.4479166666667
51660,50,6,3,56,56.8064,59,59.8496,53.75,54.524
51667,48,6,4,54,54.84375,56,56.875,51,51.796875
51861,55,6,5,61,61.7259504132231,62,62.7378512396694,57.5,58.1842975206612
51807,41,5,4,46,46.6841165972635,47,47.698988697204,43,43.639500297442
51533,49,7,5,56,57.1428571428571,58,59.1836734693878,52.5,53.5714285714286
51376,49,6,10,55,55.8246563931695,51,51.7646813827572,50.3636363636364,51.1187762674643
51513,52,9,9,61,62.8272928994083,61,62.8272928994083,55.6,57.2655325443787
51518,52,10,2,62,64.292899408284,70,72.5887573964497,67,69.4778106508876
51497,51,5,5,56,56.5382545174933,56,56.5382545174933,52.6666666666667,53.1728822247853
51715,46,7,5,53,54.2273156899811,55,56.273629489603,49.5,50.6462665406427
51594,49,9,6,58,59.9566847147022,61,63.057892544773,54.1428571428571,55.9694175046112
51597,48,1,5,49,49.0212673611111,45,45.01953125,48,48.0208333333333
51711,50,7,5,57,58.1172,59,60.1564,53.5,54.5486
51450,42,10,5,52,54.9478458049887,57,60.2312925170068,49.5,52.3061224489796
51964,45,7,4,52,53.2582716049383,55,56.3308641975309,49.2,50.3905185185185
51848,54,10,4,64,66.1947873799726,70,72.400548696845,63,65.1604938271605
51495,49,10,5,59,61.457309454394,64,66.6655560183257,56.5,58.8531861724282
51698,47,1,5,48,48.0217292892712,44,44.0199185151652,47,47.0212765957447
51624,48,4,6,52,52.3611111111111,50,50.3472222222222,48.8571428571429,49.1964285714286
51624,38,5,4,43,43.744459833795,44,44.7617728531856,40,40.6925207756233
51617,44,6,0,50,50.9297520661157,56,57.0413223140496,59,60.0971074380165
51641,41,10,4,51,54.0339083878644,57,60.3908387864366,50,52.9744199881023
51398,42,8,5,50,51.8140589569161,53,54.9229024943311,46.6666666666667,48.3597883597884
51770,44,9,6,53,55.2174586776859,56,58.3429752066116,49.1428571428571,51.1989374262102
51596,43,4,3,47,47.4067063277447,48,48.415359653867,44.5,44.8850730124392
51524,48,5,12,53,53.5750868055556,46,46.4991319444444,48.7692307692308,49.2984107905983
51551,47,7,6,54,55.1978270710729,55,56.2200090538705,50,51.1090991398823
51757,34,8,6,42,44.3252595155709,44,46.4359861591695,38,40.1038062283737
51597,44,8,2,52,53.7190082644628,58,59.9173553719008,53.3333333333333,55.0964187327824
51768,48,8,3,56,57.5555555555556,61,62.6944444444444,55,56.5277777777778
51475,36,4,4,40,40.4938271604938,40,40.4938271604938,37.2,37.6592592592593
51902,43,8,3,51,52.7652785289346,56,57.9383450513791,50,51.7306652244457
51703,55,10,3,65,67.1487603305785,72,74.3801652892562,66.25,68.4400826446281
51778,49,4,8,53,53.3531861724282,49,49.3265306122449,49.6666666666667,49.9976398722754
51652,40,4,5,44,44.44,43,43.43,41,41.41
53267,52,13,5,65,69.0625,73,77.5625,65,69.0625
52675,61,7,10,68,68.8954582101586,65,65.8559527008869,62.9090909090909,63.737509467152
52691,60,12,7,72,74.88,77,80.08,68.25,70.98
52646,60,12,5,72,74.88,79,82.16,71,73.84
53382,60,9,9,69,70.5525,69,70.5525,63.6,65.031
52754,65,8,6,73,74.105798816568,75,76.1360946745562,69,70.0452071005917
52830,54,6,5,60,60.7407407407407,61,61.7530864197531,56.5,57.1975308641975
52594,52,7,5,59,60.0691568047337,61,62.105399408284,55.5,56.5057322485207
52654,52,5,10,57,57.5269970414201,52,52.4807692307692,52.9090909090909,53.3982651963421
52771,66,8,7,74,75.0872359963269,75,76.1019283746557,69.5,70.5211202938476
52920,58,6,4,64,64.6848989298454,66,66.7063020214031,61,61.6527942925089
52975,49,6,11,55,55.8246563931695,50,50.7496876301541,50.25,51.0034360683049
52637,66,9,11,75,76.3946280991736,73,74.3574380165289,69,70.2830578512397
52746,68,9,9,77,78.3488321799308,77,78.3488321799308,71.6,72.8542387543253
52712,67,10,7,77,78.7153040766318,80,81.7821341055915,72.625,74.2428436177322
52700,54,8,5,62,63.360768175583,65,66.4266117969822,58.6666666666667,59.9542752629172
52700,61,9,14,70,71.5237839290513,65,66.4149422198334,63.4,64.7801128728836
52964,66,8,4,74,75.0872359963269,78,79.1460055096419,71.6,72.6519742883379
53016,63,3,5,66,66.1496598639456,64,64.1451247165533,63.5,63.6439909297052
52863,59,8,3,67,68.231829933927,72,73.3237575409365,66,67.2134444125251
52679,56,6,6,62,62.7117346938776,62,62.7117346938776,58.1428571428571,58.8103134110787
52601,48,6,5,54,54.84375,55,55.859375,50.5,51.2890625
52360,39,13,4,52,57.7777777777778,61,67.7777777777778,54.6,60.6666666666667
52964,68,6,9,74,74.5761245674741,71,71.55276816609,69.5,70.0410899653979
52975,61,5,4,66,66.4434291857028,67,67.4501478097286,63,63.4232733136254
52725,67,6,6,73,73.5854310536868,73,73.5854310536868,69.1428571428571,69.6973554402826
52478,54,10,8,64,66.1947873799726,66,68.2633744855967,59,61.0233196159122
52484,43,7,4,50,51.3250405624662,53,54.4045429962142,47.2,48.4508382909681
52843,70,13,5,83,85.8626530612245,91,94.1385714285714,83,85.8626530612245
52640,62,11,8,73,75.297866805411,76,78.3922996878252,68.1111111111111,70.2550872933287
52721,48,3,4,51,51.19921875,50,50.1953125,48.6,48.78984375
52726,57,10,7,67,69.0621729763004,70,72.1545090797168,62.625,64.5525161588181
53152,56,5,3,61,61.4862882653061,63,63.5022321428571,58.5,58.9663584183673
53558,64,4,7,68,68.265625,65,65.25390625,64.75,65.0029296875
52471,57,11,4,68,70.5324715297015,75,77.7931671283472,68,70.5324715297015
52605,50,11,5,61,63.9524,67,70.2428,59.1666666666667,62.0303333333333
52917,49,9,4,58,59.9566847147022,63,65.1253644314869,56.2,58.0959600166597
53000,66,8,11,74,75.0872359963269,71,72.0431588613407,68.3333333333333,69.3373125191307
52961,40,8,4,48,49.92,52,54.08,45.6,47.424
52887,53,7,6,60,61.0466358134567,61,62.064079743681,56,56.9768600925596
53258,59,6,6,65,65.6722206262568,65,65.6722206262568,61.1428571428571,61.7751877539295
52912,57,12,3,69,72.0581717451524,78,81.4570637119114,73.5,76.7576177285319
53513,52,7,8,59,60.0691568047337,58,59.0510355029586,54.3333333333333,55.3179240631164
53577,63,13,6,76,79.236079617032,83,86.5341395817586,74.1428571428571,77.2998596263902
53590,30,6,8,36,37.44,34,35.36,31.6666666666667,32.9333333333333
53534,24,2,4,26,26.1805555555556,24,24.1666666666667,24.2,24.3680555555556
53693,37,5,4,42,42.7669831994156,43,43.7852447041636,39,39.7121986851717
53764,29,4,1,33,33.627824019025,36,36.6848989298454,32,32.6087990487515
53633,26,1,2,27,27.0399408284024,26,26.0384615384615,26,26.0384615384615
53291,53,15,14,68,73.4467782128872,69,74.5268778924884,60,64.8059807760769
53861,52,11,12,63,65.8191568047337,62,64.7744082840237,56.2307692307692,58.7470129722349
53439,49,6,11,55,55.8246563931695,50,50.7496876301541,50.25,51.0034360683049
53601,47,14,3,61,66.4124038026256,72,78.3884110457221,69.75,75.9387732005432
53410,30,3,2,33,33.33,34,34.34,31,31.31
53657,48,3,9,51,51.19921875,45,45.17578125,48.3,48.488671875
53414,27,8,8,35,38.0727023319616,35,38.0727023319616,30.1111111111111,32.7546105776558
53550,23,3,0,26,26.4423440453686,29,29.4933837429112,26,26.4423440453686
53662,23,3,3,26,26.4423440453686,26,26.4423440453686,23.75,24.1540642722117
53766,30,4,2,34,34.6044444444444,36,36.64,32,32.5688888888889
53520,32,6,6,38,39.3359375,38,39.3359375,34.1428571428571,35.3431919642857
53374,48,12,9,60,63.75,63,66.9375,54.6,58.0125
53359,37,9,6,46,48.7216946676406,49,51.8991964937911,42.1428571428571,44.6363351768757
53388,45,10,6,55,57.7160493827161,59,61.9135802469136,51.4285714285714,53.968253968254
53397,33,6,4,39,40.2892561983471,41,42.3553719008264,36,37.1900826446281
53526,29,5,5,34,35.0107015457788,34,35.0107015457788,30.6666666666667,31.5782798256044
53873,30,3,3,33,33.33,33,33.33,30.75,31.0575
53856,29,6,0,35,36.4982164090369,41,42.7550535077289,44,45.8834720570749
53660,23,3,1,26,26.4423440453686,28,28.476370510397,24.5,24.9168241965974
53327,44,8,8,52,53.7190082644628,52,53.7190082644628,47.1111111111111,48.6685032139578
53886,51,10,4,61,63.3452518262207,67,69.5759323337178,60,62.3068050749712
53820,46,3,6,49,49.2084120982987,46,46.195652173913,46.4285714285714,46.6260464488253
53970,60,4,12,64,64.2844444444444,56,56.2488888888889,60.4615384615385,60.7302564102564
53378,41,11,6,52,55.743010113028,57,61.1029149315883,48.8571428571429,52.3739270842186
53411,33,7,3,40,41.7998163452709,44,45.979797979798,38.25,39.9710743801653
54100,34,6,4,40,41.2456747404844,42,43.3079584775086,37,38.1522491349481
53787,28,1,2,29,29.0369897959184,28,28.0357142857143,28,28.0357142857143
53600,37,7,3,44,45.5748721694668,48,49.718042366691,42.25,43.7622352081812
53357,35,10,3,45,48.6734693877551,52,56.2448979591837,46.25,50.0255102040816
53657,60,10,4,70,71.9444444444444,76,78.1111111111111,69,70.9166666666667
53894,36,3,3,39,39.2708333333333,39,39.2708333333333,36.75,37.0052083333333
53435,44,10,1,54,56.7892561983471,63,66.254132231405,66.5,69.9349173553719
53555,37,6,2,43,44.1307523739956,47,48.235938641344,42,43.1044558071585
53538,28,5,2,33,34.0522959183673,36,37.1479591836735,31.3333333333333,32.3324829931973
53990,50,6,3,56,56.8064,59,59.8496,53.75,54.524
54558,56,9,11,65,66.6788903061224,63,64.6272321428571,59,60.5239158163265
54414,44,10,2,54,56.7892561983471,62,65.202479338843,59,62.047520661157
54439,35,10,7,45,48.6734693877551,48,51.9183673469388,40.625,43.9413265306123
54967,46,8,1,54,55.6332703213611,61,62.8449905482042,60,61.8147448015123
55158,42,5,6,47,47.6660997732426,46,46.6519274376417,43.4285714285714,44.0440557175251
55054,36,1,6,37,37.0285493827161,32,32.0246913580247,36,36.0277777777778
55794,41,5,5,46,46.6841165972635,46,46.6841165972635,42.6666666666667,43.3012095974618
55108,49,5,5,54,54.5622657226156,54,54.5622657226156,50.6666666666667,51.194224628627
54762,41,6,1,47,48.0065437239738,52,53.1136228435455,48.5,49.5386674598453
55306,41,4,7,45,45.4283164782867,42,42.399762046401,41.75,42.1473825104105
54729,32,4,5,36,36.5625,35,35.546875,33,33.515625
54879,64,11,8,75,77.215576171875,78,80.30419921875,70.1111111111111,72.1822645399306
55225,55,6,8,61,61.7259504132231,59,59.7021487603306,56.6666666666667,57.3410468319559
54533,41,8,6,49,50.8655562165378,51,52.9417013682332,45,46.7132659131469
54640,42,3,8,45,45.2295918367347,40,40.2040816326531,42.3333333333333,42.5493197278912
55244,45,3,5,48,48.2133333333333,46,46.2044444444444,45.5,45.7022222222222
54603,26,6,1,32,33.7041420118343,37,38.9704142011834,33.5,35.2840236686391
54626,28,6,1,34,35.5612244897959,39,40.7908163265306,35.5,37.1301020408163
54974,54,2,9,56,56.076817558299,49,49.0672153635117,54.1,54.1742112482853
54609,35,12,4,47,52.5248979591837,55,61.465306122449,48.2,53.8659591836735
55028,38,7,5,45,46.5270083102493,47,48.5948753462604,41.5,42.9082409972299
54946,32,5,4,37,37.9033203125,38,38.927734375,34,34.830078125
54513,30,6,2,36,37.44,40,41.6,35,36.4
54923,38,6,4,44,45.0969529085873,46,47.1468144044321,41,42.0221606648199
54685,25,5,3,30,31.2,32,33.28,27.5,28.6
54407,41,9,8,50,52.4092801903629,51,53.4574657941701,45,47.1683521713266
54774,49,9,4,58,59.9566847147022,63,65.1253644314869,56.2,58.0959600166597
55343,46,9,3,55,57.1053875236295,61,63.3350661625709,55,57.1053875236295
55021,38,8,4,46,48.0387811634349,50,52.2160664819945,43.6,45.5324099722992
55049,33,5,6,38,38.8723599632691,37,37.8494031221304,34.4285714285714,35.2189426734881
55377,25,3,3,28,28.4032,28,28.4032,25.75,26.1208
55181,24,8,4,32,35.5555555555556,36,40,29.6,32.8888888888889
55440,26,4,2,30,30.7100591715976,32,32.7573964497041,28,28.6627218934911
55314,21,1,4,22,22.0498866213152,19,19.0430839002268,21,21.047619047619
55605,27,5,5,32,33.0973936899863,32,33.0973936899863,28.6666666666667,29.649748513946
55400,29,7,5,36,38.0975029726516,38,40.2140309155767,32.5,34.3935790725327
55475,28,5,2,33,34.0522959183673,36,37.1479591836735,31.3333333333333,32.3324829931973
55540,22,3,2,25,25.4648760330579,26,26.4834710743802,23,23.4276859504132
55490,48,10,10,58,60.5173611111111,58,60.5173611111111,52.0909090909091,54.3517992424242
55162,24,5,4,29,30.2586805555556,30,31.3020833333333,26,27.1284722222222
55240,17,2,3,19,19.2629757785467,18,18.2491349480969,17.25,17.4887543252595
55105,13,3,2,16,16.8520710059172,17,17.905325443787,14,14.7455621301775
55261,22,3,3,25,25.4648760330579,25,25.4648760330579,22.75,23.1730371900826
55317,22,0,2,22,22,20,20,22,22
55189,22,4,3,26,26.8595041322314,27,27.8925619834711,23.5,24.2768595041322
55549,28,6,5,34,35.5612244897959,35,36.6071428571429,30.5,31.9005102040816
56125,27,3,7,30,30.3703703703704,26,26.320987654321,27.375,27.712962962963
55326,11,3,0,14,15.0413223140496,17,18.2644628099174,14,15.0413223140496
55222,16,2,3,18,18.28125,17,17.265625,16.25,16.50390625
55721,40,8,2,48,49.92,54,56.16,49.3333333333333,51.3066666666667
56471,45,5,8,50,50.6172839506173,47,47.5802469135802,46.1111111111111,46.6803840877915
56815,48,7,5,55,56.1697048611111,57,58.2122395833333,51.5,52.5952690972222
56463,54,11,10,65,67.6971879286694,66,68.738683127572,59,61.4482167352538
56623,61,11,6,72,74.3413061005106,77,79.503896801935,68.8571428571429,71.0962490881868
56666,54,13,4,67,70.8830589849108,76,80.4046639231824,69.6,73.6337448559671
56770,60,12,5,72,74.88,79,82.16,71,73.84
56971,60,6,7,66,66.66,65,65.65,61.875,62.49375
56664,57,7,3,64,64.9652200677131,68,69.0255463219452,62.25,63.1888273314866
56555,50,5,7,55,55.55,53,53.53,51.25,51.7625
56835,64,10,7,74,75.806640625,77,78.8798828125,69.625,71.3248291015625
56516,49,6,6,55,55.8246563931695,55,55.8246563931695,51.1428571428571,51.9096804902719
56510,46,8,5,54,55.6332703213611,57,58.7240075614367,50.6666666666667,52.1991178323882
56733,59,14,5,73,77.1103131284114,82,86.6170640620511,74.1666666666667,78.3426697309202
56724,67,15,1,82,86.1100467810203,96,100.811762085097,119.5,125.489641345511
56538,53,10,8,63,65.2427910288359,65,67.313990744037,58,60.064791740833
56723,55,13,10,68,71.7990082644628,71,74.9666115702479,62.0909090909091,65.5597896318558
56321,32,9,9,41,44.2431640625,41,44.2431640625,35.6,38.416015625
57379,24,4,2,28,28.7777777777778,30,30.8333333333333,26,26.7222222222222
57432,26,3,3,29,29.3860946745562,29,29.3860946745562,26.75,27.1061390532544
57574,34,3,3,37,37.288062283737,37,37.288062283737,34.75,35.020544982699
57461,22,2,1,24,24.198347107438,25,25.2066115702479,22.5,22.6859504132231
57312,35,6,9,41,42.2048979591837,38,39.1167346938775,36.5,37.5726530612245
57397,33,5,5,38,38.8723599632691,38,38.8723599632691,34.6666666666667,35.4625038261402
57563,33,6,2,39,40.2892561983471,43,44.4214876033058,38,39.2561983471074
57576,43,5,5,48,48.6489994591671,48,48.6489994591671,44.6666666666667,45.2705967189472
57732,36,2,2,38,38.1172839506173,38,38.1172839506173,36.3333333333333,36.4454732510288
57388,30,2,1,32,32.1422222222222,33,33.1466666666667,30.5,30.6355555555556
57473,33,6,3,39,40.2892561983471,42,43.3884297520661,36.75,37.9648760330578
57396,33,10,2,43,46.9485766758494,51,55.6831955922865,48,52.4077134986226
57420,25,2,0,27,27.1728,29,29.1856,26,26.1664
57366,31,6,1,37,38.3860561914672,42,43.573361082206,38.5,39.9422476586889
57283,21,3,3,24,24.4897959183673,24,24.4897959183673,21.75,22.1938775510204
57261,23,3,1,26,26.4423440453686,28,28.476370510397,24.5,24.9168241965974
57548,46,12,4,58,61.9470699432892,66,70.4914933837429,59.2,63.2287334593573
58313,53,13,9,66,69.9708081167675,70,74.2114631541474,60.8,64.4579565681737
58642,67,12,7,79,81.534194698151,84,86.6945867676543,75.25,77.6639006460236
58590,59,9,7,68,69.5823039356507,70,71.6288422866992,63.5,64.9775926457914
58459,55,14,5,69,73.4707438016529,78,83.0538842975207,70.1666666666667,74.7130027548209
58597,72,11,10,83,84.9373070987654,84,85.9606481481481,77,78.7972608024691
58562,61,13,3,74,77.360924482666,84,87.81510346681,80.5,84.1561408223596
58665,57,4,5,61,61.3004001231148,60,60.2954755309326,58,58.2856263465682
58354,56,16,9,72,77.8775510204082,79,85.4489795918367,68,73.5510204081633
58487,62,13,9,75,78.2973465140479,79,82.4732049947971,69.8,72.8687304890739
58402,58,14,10,72,76.1950059453032,76,80.4280618311534,66.2727272727273,70.1340395632905
58490,57,14,8,71,75.2831640504771,77,81.6451215758695,67.1111111111111,71.1596730617968
58648,64,13,4,77,80.177001953125,86,89.54833984375,79.6,82.88427734375
58657,61,11,9,72,74.3413061005106,74,76.4063423810804,66.5,68.6624563289438
58398,51,7,8,58,59.0926566705113,57,58.0738177623991,53.3333333333333,54.3380750993208
58364,58,12,13,70,72.9964328180737,69,71.9536266349584,62.7142857142857,65.3988449125191
58583,64,12,3,76,78.671875,85,87.98828125,80.5,83.330078125
58597,54,12,2,66,69.2592592592593,76,79.7530864197531,76,79.7530864197531
58652,63,12,4,75,77.7210884353741,83,86.0113378684807,76.2,78.9646258503401
58849,59,5,8,64,64.4596380350474,61,61.4380925021546,60.1111111111111,60.5428197516678
58329,51,12,7,63,66.4878892733564,68,71.7647058823529,59.25,62.530276816609
58909,63,9,6,72,73.469387755102,75,76.530612244898,68.1428571428571,69.533527696793
58490,51,14,6,65,69.8981161091888,73,78.5009611687812,64,68.8227604767397
59630,46,2,3,48,48.0907372400756,47,47.0888468809074,46.25,46.3374291115312
59490,43,7,7,50,51.3250405624662,50,51.3250405624662,45.625,46.8340995132504
59530,45,9,1,54,56.16,62,64.48,63,65.52
59626,45,7,2,52,53.2582716049383,57,58.3792592592593,52,53.2582716049383
59454,47,7,7,54,55.1978270710729,54,55.1978270710729,49.625,50.7257808963332
60374,52,8,3,60,61.4201183431953,65,66.5384615384615,59,60.396449704142
59430,43,9,3,52,54.2779881016766,58,60.5408328826393,52,54.2779881016766
59423,61,11,8,72,74.3413061005106,75,77.4388605213652,67.1111111111111,69.2934396368957
59712,49,8,3,57,58.5193669304456,62,63.6526447313619,56,57.4927113702624
59644,62,12,7,74,76.7721123829345,79,81.9594172736733,70.25,72.8816337148803
59781,48,6,8,54,54.84375,52,52.8125,49.6666666666667,50.4427083333333
59349,39,6,9,45,46.0650887573964,42,42.9940828402367,40.5,41.4585798816568
59258,44,16,5,60,67.9338842975207,71,80.3884297520661,64,72.4628099173554
60852,52,8,6,60,61.4201183431953,62,63.4674556213018,56,57.3254437869822
59900,55,10,3,65,67.1487603305785,72,74.3801652892562,66.25,68.4400826446281
59824,47,6,3,53,53.8637392485287,56,56.9126301493889,50.75,51.5770710728837
60051,62,11,5,73,75.297866805411,79,81.4867325702393,71.1666666666667,73.4068244883802
60659,57,10,10,67,69.0621729763004,67,69.0621729763004,61.0909090909091,62.9712079241165
60195,22,2,4,24,24.198347107438,22,22.1818181818182,22.2,22.3834710743802
60769,73,14,8,87,90.1998498780259,93,96.4205291799587,83.1111111111111,86.1679281082546
60673,69,8,8,77,78.0350766645663,77,78.0350766645663,72.1111111111111,73.0804686223716
60706,31,7,3,38,39.9375650364204,42,44.1415192507804,36.25,38.0983350676379
60772,29,9,3,38,41.6599286563615,44,48.2378121284185,38,41.6599286563615
60366,30,8,2,38,40.7022222222222,44,47.1288888888889,39.3333333333333,42.1303703703704
60308,46,9,9,55,57.1053875236295,55,57.1053875236295,49.6,51.4986767485822
60784,61,10,8,71,72.9080892233271,73,74.9618382155335,66,67.7737167428111
60634,42,9,2,51,53.3418367346939,58,60.6632653061224,54,56.4795918367347
60494,34,8,5,42,44.3252595155709,45,47.4913494809689,38.6666666666667,40.8073817762399
60430,26,2,5,28,28.1656804733728,25,25.1479289940828,26.1666666666667,26.3214990138067
60315,32,11,2,43,48.0810546875,52,58.14453125,50.3333333333333,56.2809244791667
60243,37,11,10,48,52.2425127830533,49,53.3308984660336,42,45.7121986851717
60393,46,6,8,52,52.8846880907372,50,50.8506616257089,47.6666666666667,48.4776307498425
60449,32,8,5,40,42.5,43,45.6875,36.6666666666667,38.9583333333333
60301,23,7,2,30,32.7788279773157,35,38.241965973535,30,32.7788279773157
60592,37,5,2,42,42.7669831994156,45,45.8217677136596,40.3333333333333,41.0698806915023
60704,51,10,8,61,63.3452518262207,63,65.4221453287197,56,58.1530180699731
60212,23,4,4,27,27.8166351606805,27,27.8166351606805,24.2,24.9319470699433
60315,32,7,6,39,40.8662109375,40,41.9140625,35,36.6748046875
60226,15,1,3,16,16.0711111111111,14,14.0622222222222,15,15.0666666666667
60387,37,8,7,45,47.1037253469686,46,48.1504747991234,40.5,42.3933528122717
60566,22,3,2,25,25.4648760330579,26,26.4834710743802,23,23.4276859504132
60468,47,5,5,52,52.5885015844273,52,52.5885015844273,48.6666666666667,49.2174437905538
60651,49,3,3,52,52.1949187838401,52,52.1949187838401,49.75,49.9364847980008
60747,76,14,5,90,93.0540166204986,99,102.359418282548,91.1666666666667,94.2602723915051
60356,27,6,6,33,34.6296296296296,33,34.6296296296296,29.1428571428571,30.5820105820106
60313,32,9,7,41,44.2431640625,43,46.4013671875,36.5,39.38720703125
60542,29,6,2,35,36.4982164090369,39,40.6694411414982,34,35.4554102259215
60611,30,4,4,34,34.6044444444444,34,34.6044444444444,31.2,31.7546666666667
60479,50,7,8,57,58.1172,56,57.0976,52.3333333333333,53.3590666666667
60271,42,16,7,58,66.4172335600907,67,76.7233560090703,57,65.2721088435374
60707,44,7,4,51,52.290805785124,54,55.3667355371901,48.2,49.4199380165289
60681,43,7,8,50,51.3250405624662,49,50.2985397512169,45.3333333333333,46.5347034433027
60560,31,7,3,38,39.9375650364204,42,44.1415192507804,36.25,38.0983350676379
60240,17,0,5,17,17,12,12,17,17
60852,55,11,5,66,68.64,72,74.88,64.1666666666667,66.7333333333333
60402,56,9,4,65,66.6788903061224,70,71.8080357142857,63.2,64.8323979591837
60604,59,14,6,73,77.1103131284114,81,85.5607584027578,72,76.0540074691181
60250,29,8,6,37,39.8156956004756,39,41.9678953626635,33,35.5112960760999
60864,30,2,3,32,32.1422222222222,31,31.1377777777778,30.25,30.3844444444444
60386,34,7,4,41,42.7378892733564,44,45.8650519031142,38.2,39.8192041522491
60382,34,5,3,39,39.8434256055363,41,41.886678200692,36.5,37.2893598615917
60439,48,10,6,58,60.5173611111111,62,64.6909722222222,54.4285714285714,56.7909226190476
60647,45,11,6,56,59.3461728395062,61,64.6449382716049,52.8571428571429,56.0155202821869
60729,30,7,3,37,39.0144444444445,41,43.2322222222222,35.25,37.1691666666667
60278,21,7,2,28,31.1111111111111,33,36.6666666666667,28,31.1111111111111
60229,22,6,5,28,30.0826446280992,29,31.1570247933884,24.5,26.3223140495868
60415,49,12,5,61,64.658475635152,68,72.0783007080383,60,63.5985006247397
60466,33,9,3,42,45.1239669421488,48,51.5702479338843,42,45.1239669421488
60402,22,5,1,27,28.3946280991736,31,32.6012396694215,27,28.3946280991736
60759,45,7,9,52,53.2582716049383,50,51.2098765432099,47.1,48.2397037037037
60783,68,10,8,78,79.6868512110727,80,81.7301038062284,73,74.5787197231834
60769,32,6,4,38,39.3359375,40,41.40625,35,36.23046875
60384,35,13,4,48,54.6220408163265,57,64.8636734693878,50.6,57.5807346938776
60455,23,2,2,25,25.1890359168242,25,25.1890359168242,23.3333333333333,23.5097668557026
60636,44,8,4,52,53.7190082644628,56,57.8512396694215,49.6,51.2396694214876
60330,13,4,2,17,18.6094674556213,19,20.7988165680473,15,16.4201183431953
61840,68,10,4,78,79.6868512110727,84,85.8166089965398,77,78.6652249134948
61591,50,9,6,59,60.9116,62,64.0088,55.1428571428571,56.9294857142857
61587,64,12,6,76,78.671875,82,84.8828125,73.4285714285714,76.0100446428571
61645,60,14,6,74,78.0288888888889,82,86.4644444444445,73,76.9744444444444
61652,60,5,5,65,65.4513888888889,65,65.4513888888889,61.6666666666667,62.0949074074074
61615,65,14,10,79,82.6648520710059,83,86.8504142011834,73.2727272727273,76.6718881118881
62008,71,12,8,83,85.3709581432256,87,89.4852211862726,78.3333333333333,80.570984593004
61532,59,13,6,72,75.4955472565355,79,82.8353921286987,70.1428571428571,73.5482414741248
61664,45,5,5,50,50.6172839506173,50,50.6172839506173,46.6666666666667,47.2427983539095
61662,63,11,9,74,76.2559838750315,76,78.3169564121945,68.5,70.5883093978332
61544,65,8,7,73,74.105798816568,74,75.1209467455621,68.5,69.5376331360947
61736,74,14,6,88,91.1497443389335,96,99.436084733382,87,90.1139517896275
61624,55,9,5,64,65.7137190082645,68,69.820826446281,61,62.6333884297521
61856,59,12,5,71,73.9370870439529,78,81.2266590060327,70,72.8957196207986
61788,68,15,9,83,87.0387110726644,89,93.3306660899654,78.5,82.3197448096886
61745,62,8,11,70,71.165452653486,67,68.1155046826223,64.3333333333333,65.4044398196323
61524,77,17,10,94,98.5818856468207,101,105.923089897116,89.3636363636364,93.7195295849369
61512,53,13,7,66,69.9708081167675,72,76.3317906728373,62.75,66.5252758988964
61844,70,8,11,78,79.0187755102041,75,75.9795918367347,72.3333333333333,73.2780952380952
61807,64,12,8,76,78.671875,80,82.8125,71.3333333333333,73.8411458333333
61630,66,14,8,80,83.5996326905418,86,89.8696051423324,76.1111111111111,79.5357616569738
61729,64,14,6,78,81.732421875,86,90.115234375,77,80.6845703125
62844,62,6,7,68,68.636836628512,67,67.627471383975,63.875,64.4732049947971
61780,49,7,3,56,57.1428571428571,60,61.2244897959184,54.25,55.3571428571429
62300,71,6,6,77,77.5498908946638,77,77.5498908946638,73.1428571428571,73.6652024825006
62656,71,9,5,80,81.2854592342789,84,85.3497321959929,77,78.2372545129935
62029,69,11,3,80,82.033186305398,88,90.2365049359378,82.75,84.8530770846461
61979,55,9,1,64,65.7137190082645,72,73.9279338842975,73,74.9547107438017
61872,51,10,7,61,63.3452518262207,64,66.4605920799692,56.625,58.802047289504
61750,61,12,11,73,75.8250470303682,74,76.8637463047568,66.5,69.0735017468422
61808,49,8,5,57,58.5193669304456,60,61.5993336109954,53.6666666666667,55.0971817298348
62075,62,13,9,75,78.2973465140479,79,82.4732049947971,69.8,72.8687304890739
61755,63,13,10,76,79.236079617032,79,82.3638196019148,70.0909090909091,73.0753796468082
61663,60,8,10,68,69.2088888888889,66,67.1733333333333,62.5454545454545,63.6573737373737
61524,56,13,8,69,72.718431122449,74,77.9878826530612,64.6666666666667,68.1515731292517
61945,50,8,6,58,59.4848,60,61.536,54,55.3824
61922,54,13,4,67,70.8830589849108,76,80.4046639231824,69.6,73.6337448559671
61964,58,11,5,69,71.4818668252081,75,77.6976813317479,67.1666666666667,69.582590170432
61981,49,6,6,55,55.8246563931695,55,55.8246563931695,51.1428571428571,51.9096804902719
61522,40,8,6,48,49.92,50,52,44,45.76
61753,44,7,3,51,52.290805785124,55,56.3920454545455,49.25,50.4965134297521
61706,49,9,6,58,59.9566847147022,61,63.057892544773,54.1428571428571,55.9694175046112
61995,59,4,5,63,63.2895719620799,62,62.2849755817294,60,60.2757828210284
61847,58,11,4,69,71.4818668252081,76,78.7336504161712,69,71.4818668252081
61599,49,4,6,53,53.3531861724282,51,51.3398583923365,49.8571428571429,50.1893853751413
61690,48,6,11,54,54.84375,49,49.765625,49.25,50.01953125
61634,61,8,11,69,70.1867777479172,66,67.1351787153991,63.3333333333333,64.4226462420496
61752,48,10,4,58,60.5173611111111,64,66.7777777777778,57,59.4739583333333
61601,62,11,7,73,75.297866805411,77,79.4237773152966,68.875,71.0430215920916
61535,58,14,6,72,76.1950059453032,80,84.6611177170036,71,75.1367419738407
61444,46,6,6,52,52.8846880907372,52,52.8846880907372,48.1428571428571,48.9619227653254
61473,46,7,7,53,54.2273156899811,53,54.2273156899811,48.625,49.7510042533081
61836,64,14,5,78,81.732421875,87,91.1630859375,79.1666666666667,82.9549153645833
61719,62,5,5,67,67.4357440166493,67,67.4357440166493,63.6666666666667,64.0807318765175
61622,50,9,8,59,60.9116,60,61.944,54,55.7496
61870,49,8,7,57,58.5193669304456,58,59.5460224906289,52.5,53.899416909621
61412,45,10,9,55,57.7160493827161,56,58.7654320987654,49.5,51.9444444444444
61469,57,10,8,67,69.0621729763004,69,71.123730378578,62,63.9082794706063
61507,48,5,5,53,53.5750868055556,53,53.5750868055556,49.6666666666667,50.2055844907407
62069,66,10,8,76,77.7447199265381,78,79.7906336088154,71,72.6299357208448
61823,45,2,5,47,47.0928395061728,44,44.0869135802469,45.1666666666667,45.2558847736626
62135,75,8,4,83,83.9443555555555,87,87.9898666666667,80.6,81.5170488888889
61789,56,12,9,68,71.1224489795918,71,74.2602040816327,62.6,65.4744897959184
61907,58,12,7,70,72.9964328180737,75,78.2104637336504,66.25,69.0859096313912
62111,71,8,6,79,80.0029756000793,81,82.0283673874231,75,75.9521920253918
61657,52,8,6,60,61.4201183431953,62,63.4674556213018,56,57.3254437869822
61571,64,12,12,76,78.671875,76,78.671875,69.0769230769231,71.5054086538462
61905,73,13,9,86,88.7273409645337,90,92.8541940326515,80.8,83.3624319759805
61867,44,7,9,51,52.290805785124,49,50.2401859504132,46.1,47.2667871900826
61500,49,14,13,63,68.1428571428572,64,69.2244897959184,55.5,60.030612244898
62175,63,9,9,72,73.469387755102,72,73.469387755102,66.6,67.9591836734694
61563,48,10,6,58,60.5173611111111,62,64.6909722222222,54.4285714285714,56.7909226190476
61721,45,10,3,55,57.7160493827161,62,65.0617283950617,56.25,59.0277777777778
63742,57,5,5,62,62.4770698676516,62,62.4770698676516,58.6666666666667,59.1180876167026
63901,43,7,3,50,51.3250405624662,54,55.4310438074635,48.25,49.5286641427799
63329,51,9,12,60,61.8685121107266,57,58.7750865051903,53.7692307692308,55.4437050838435
63353,45,9,4,54,56.16,59,61.36,52.2,54.288
64357,68,10,3,78,79.6868512110727,85,86.8382352941177,79.25,80.963884083045
63950,54,11,2,65,67.6971879286694,74,77.0706447187929,72.3333333333333,75.3348193872885
63744,47,5,1,52,52.5885015844273,56,56.6337709370756,52,52.5885015844273
63364,45,9,3,54,56.16,60,62.4,54,56.16
63633,53,1,6,54,54.0192239231043,49,49.0174439302243,53,53.0188679245283
64080,66,5,8,71,71.4074839302112,68,68.3902662993572,67.1111111111111,67.4962758902153
63711,70,10,6,80,81.6326530612245,84,85.7142857142857,76.4285714285714,77.9883381924198
63669,55,7,4,62,63.0042975206612,65,66.0528925619835,59.2,60.1589421487603
63598,45,6,5,51,51.9066666666667,52,52.9244444444444,47.5,48.3444444444444
63328,48,12,8,60,63.75,64,68,55.3333333333333,58.7916666666667
64266,66,6,1,72,72.595041322314,77,77.6363636363636,73.5,74.1074380165289
63856,53,8,7,61,62.3898184407262,62,63.4126023495906,56.5,57.7872908508366
63744,51,5,7,56,56.5382545174933,54,54.5190311418685,52.25,52.7522106881968
63785,60,5,7,65,65.4513888888889,63,63.4375,61.25,61.6753472222222
63865,50,12,3,62,65.5712,71,75.0896,66.5,70.3304
63557,50,9,7,59,60.9116,61,62.9764,54.5,56.2658
63969,57,4,1,61,61.3004001231148,64,64.3151738996614,60,60.2954755309326
63816,61,9,2,70,71.5237839290513,77,78.6761623219565,73,74.5890889545821
64440,58,5,8,63,63.468192627824,60,60.4458977407848,59.1111111111111,59.5504029594398
63633,36,4,8,40,40.4938271604938,36,36.4444444444444,36.6666666666667,37.119341563786
64028,62,12,11,74,76.7721123829345,75,77.8095733610822,67.5,70.028616024974
63692,57,3,12,60,60.1662049861496,51,51.1412742382271,57.2307692307692,57.3893032175581
63904,52,9,3,61,62.8272928994083,67,69.0070266272189,61,62.8272928994083
63714,42,9,6,51,53.3418367346939,54,56.4795918367347,47.1428571428571,49.3075801749271
63794,55,12,7,67,70.1894214876033,72,75.4274380165289,63.25,66.2609090909091
63667,49,9,8,58,59.9566847147022,59,60.9904206580591,53,54.7880049979175
63492,43,12,8,55,59.283396430503,59,63.5949161709032,50.3333333333333,54.2532900667027
64137,69,9,9,78,79.3270321361059,78,79.3270321361059,72.6,73.8351606805293
63895,47,3,6,50,50.2037120869172,47,47.1914893617021,47.4285714285714,47.6218068938757
64001,55,5,3,60,60.495867768595,62,62.5123966942149,57.5,57.9752066115702
64280,60,8,2,68,69.2088888888889,74,75.3155555555555,69.3333333333333,70.5659259259259
64347,59,6,10,65,65.6722206262568,61,61.6308532031026,60.3636363636364,60.9879083857826
64027,57,9,7,66,67.6454293628809,68,69.6952908587258,61.5,63.0332409972299
64031,56,7,4,63,63.984375,66,67.03125,60.2,61.140625
63621,41,10,5,51,54.0339083878644,56,59.3313503866746,48.5,51.3851873884593
63665,52,14,5,66,70.7840236686391,75,80.4363905325444,67.1666666666667,72.0352564102564
63974,50,6,8,56,56.8064,54,54.7776,51.6666666666667,52.4106666666667
64047,56,8,10,64,65.3061224489796,62,63.265306122449,58.5454545454545,59.7402597402597
63984,53,8,5,61,62.3898184407262,64,65.4581701673193,57.6666666666667,58.9805387445117
64005,51,6,4,57,57.7889273356401,59,59.8166089965398,54,54.7474048442907
63954,53,5,3,58,58.5161979352083,60,60.5339978640085,55.5,55.9939480242079
64082,56,4,5,60,60.3061224489796,59,59.3010204081633,57,57.2908163265306
64038,49,5,7,54,54.5622657226156,52,52.5414410662224,50.25,50.7732194918784
65097,35,2,3,37,37.1208163265306,36,36.1175510204082,35.25,35.3651020408163
64726,48,6,8,54,54.84375,52,52.8125,49.6666666666667,50.4427083333333
65228,39,3,1,42,42.2485207100592,44,44.2603550295858,40.5,40.7396449704142
65319,41,1,6,42,42.0249851279001,37,37.022010707912,41,41.0243902439024
64876,37,6,3,43,44.1307523739956,46,47.2096420745069,40.75,41.8215850986121
64550,44,7,6,51,52.290805785124,52,53.3161157024793,47,48.1895661157025
65138,54,7,5,61,62.0250342935528,63,64.0586419753086,57.5,58.4662208504801
65097,41,12,3,53,57.5401546698394,62,67.3111243307555,57.5,62.4256395002974
66572,46,4,3,50,50.3780718336484,51,51.3856332703214,47.5,47.859168241966
65655,45,4,4,49,49.3871604938272,49,49.3871604938272,46.2,46.565037037037
64649,35,9,4,44,46.909387755102,49,52.24,42.2,44.9903673469388
65565,30,5,3,35,35.9722222222222,37,38.0277777777778,32.5,33.4027777777778
64622,25,4,5,29,29.7424,28,28.7168,26,26.6656
64981,41,4,9,45,45.4283164782867,40,40.3807257584771,41.6,41.9959547888162
64419,29,8,2,37,39.8156956004756,43,46.2722948870392,38.3333333333333,41.2504954419342
64761,34,2,3,36,36.1245674740484,35,35.121107266436,34.25,34.3685121107266
65121,48,9,7,57,59.00390625,59,61.07421875,52.5,54.345703125
65873,62,11,6,73,75.297866805411,78,80.455254942768,69.8571428571429,72.0560799762153
65071,46,2,4,48,48.0907372400756,46,46.0869565217391,46.2,46.2873345935728
64519,47,9,6,56,58.0534178361249,59,61.1634223630602,52.1428571428571,54.0548405872082
65572,44,6,5,50,50.9297520661157,51,51.948347107438,46.5,47.3646694214876
65557,43,8,3,51,52.7652785289346,56,57.9383450513791,50,51.7306652244457
64777,42,9,5,51,53.3418367346939,55,57.5255102040816,48,50.2040816326531
64337,23,5,2,28,29.3232514177694,31,32.4650283553875,26.3333333333333,27.5778197857593
64526,35,7,2,42,43.68,47,48.88,42,43.68
65956,50,6,4,56,56.8064,58,58.8352,53,53.7632
66316,47,3,6,50,50.2037120869172,47,47.1914893617021,47.4285714285714,47.6218068938757
65685,41,7,5,48,49.3991671624033,50,51.4574657941701,44.5,45.7971445568114
65714,67,9,6,76,77.3713521942526,79,80.42548451771,72.1428571428571,73.4446106355217
64811,35,5,0,40,40.8163265306122,45,45.9183673469388,45,45.9183673469388
65551,49,5,5,54,54.5622657226156,54,54.5622657226156,50.6666666666667,51.194224628627
65224,34,8,7,42,44.3252595155709,43,45.3806228373702,37.5,39.576124567474
65545,52,14,8,66,70.7840236686391,72,77.2189349112426,62.1111111111111,66.6132478632479
65458,38,4,6,42,42.4653739612188,40,40.4432132963989,38.8571428571429,39.2876929165018
65509,61,13,9,74,77.360924482666,78,81.5425960763236,68.8,71.924751410911
65789,63,7,6,70,70.8641975308642,71,71.8765432098765,66,66.8148148148148
65457,58,13,8,71,74.5668846611177,76,79.8180737217598,66.6666666666667,70.0158541418946
65770,55,5,7,60,60.495867768595,58,58.4793388429752,56.25,56.7148760330578
65758,57,9,6,66,67.6454293628809,69,70.7202216066482,62.1428571428571,63.6921250494658
65754,56,12,8,68,71.1224489795918,72,75.3061224489796,63.3333333333333,66.2414965986395
65444,42,9,4,51,53.3418367346939,56,58.5714285714286,49.2,51.4591836734694
65461,51,13,8,64,68.158400615148,69,73.4832756632065,59.6666666666667,63.5435089068307
65947,40,6,5,46,47.035,47,48.0575,42.5,43.45625
65580,60,10,10,70,71.9444444444444,70,71.9444444444444,64.0909090909091,65.8712121212121
65792,46,5,8,51,51.6025519848771,48,48.5671077504726,47.1111111111111,47.6677168662046
67439,60,12,10,72,74.88,74,76.96,66,68.64
67460,37,8,4,45,47.1037253469686,49,51.290723155588,42.6,44.5915266617969
66992,49,9,4,58,59.9566847147022,63,65.1253644314869,56.2,58.0959600166597
67535,62,13,5,75,78.2973465140479,83,86.6490634755463,75,78.2973465140479
66842,41,14,4,55,61.4128494943486,65,72.5788221296847,59.2,66.1025580011898
67364,40,11,5,51,54.856875,57,61.310625,49.1666666666667,52.8848958333333
67371,71,18,3,89,94.7202935925412,104,110.68438801825,109.25,116.271821067249
67013,62,11,6,73,75.297866805411,78,80.455254942768,69.8571428571429,72.0560799762153
66611,45,9,5,54,56.16,58,60.32,51,53.04
66729,61,8,7,69,70.1867777479172,70,71.2039774254233,64.5,65.60937919914
66690,34,11,4,45,49.7102076124567,52,57.4429065743945,45,49.7102076124567
66539,55,9,8,64,65.7137190082645,65,66.7404958677686,59,60.5798347107438
66836,41,5,6,46,46.6841165972635,45,45.669244497323,42.4285714285714,43.0595733831903
67709,51,7,8,58,59.0926566705113,57,58.0738177623991,53.3333333333333,54.3380750993208
66696,58,14,8,72,76.1950059453032,78,82.5445897740785,68.1111111111111,72.0795349451711
66943,56,7,9,63,63.984375,61,61.953125,58.1,59.0078125
66820,44,8,4,52,53.7190082644628,56,57.8512396694215,49.6,51.2396694214876
67032,70,8,10,78,79.0187755102041,76,76.9926530612245,72.5454545454545,73.492987012987
67635,78,11,5,89,90.7700525969757,95,96.8893819855358,87.1666666666667,88.9002575060267
67043,58,5,9,63,63.468192627824,59,59.4384661117717,59,59.4384661117717
67070,51,7,5,58,59.0926566705113,60,61.1303344867359,54.5,55.5267204921184
67193,41,14,3,55,61.4128494943486,66,73.6954193932183,63.75,71.1830755502677
66558,52,8,5,60,61.4201183431953,63,64.491124260355,56.6666666666667,58.0078895463511
66680,60,11,6,71,73.3863888888889,76,78.5544444444444,67.8571428571429,70.1378968253968
67584,70,6,5,76,76.5583673469388,77,77.5657142857143,72.5,73.0326530612245
67564,59,7,5,66,66.9290433783396,68,68.9571962079862,62.5,63.3797759264579
66551,55,12,7,67,70.1894214876033,72,75.4274380165289,63.25,66.2609090909091
66436,50,9,9,59,60.9116,59,60.9116,53.6,55.33664
66579,53,9,5,62,63.7878248487006,66,67.9031683873264,59,60.7013171947312
67170,57,3,6,60,60.1662049861496,57,57.1578947368421,57.4285714285714,57.587653343886
66889,64,10,4,74,75.806640625,80,81.953125,73,74.7822265625
66888,63,6,7,69,69.6258503401361,68,68.6167800453515,64.875,65.4634353741497
67115,41,9,6,50,52.4092801903629,53,55.5538370017847,46.1428571428571,48.3662785756777
66953,51,9,7,60,61.8685121107266,62,63.9307958477509,55.5,57.2283737024221
67466,54,13,4,67,70.8830589849108,76,80.4046639231824,69.6,73.6337448559671
67162,52,6,5,58,58.7721893491124,59,59.7855029585799,54.5,55.2255917159763
66863,44,11,8,55,58.4375,58,61.625,50.1111111111111,53.2430555555556
67116,66,12,8,78,80.5785123966942,82,84.7107438016529,73.3333333333333,75.7575757575758
67062,55,6,8,61,61.7259504132231,59,59.7021487603306,56.6666666666667,57.3410468319559
67085,54,4,9,58,58.318244170096,53,53.2908093278464,54.6,54.8995884773663
66934,40,7,7,47,48.439375,47,48.439375,42.625,43.930390625
66579,45,14,8,59,64.7106172839506,65,71.2913580246913,55.1111111111111,60.4453223593964
67012,58,7,11,65,65.9467895362664,61,61.8885255648038,59.75,60.6203180737218
67041,68,4,7,72,72.2491349480969,69,69.2387543252595,68.75,68.9878892733564
66616,45,10,6,55,57.7160493827161,59,61.9135802469136,51.4285714285714,53.968253968254
67858,48,10,4,58,60.5173611111111,64,66.7777777777778,57,59.4739583333333
67577,38,5,6,43,43.744459833795,42,42.7271468144044,39.4285714285714,40.1111990502572
68065,42,4,6,46,46.4172335600907,44,44.3990929705215,42.8571428571429,43.245869776482
67635,58,7,6,65,65.9467895362664,66,66.961355529132,61,61.8885255648038
67625,52,6,7,58,58.7721893491124,57,57.758875739645,53.875,54.5922707100592
67950,55,12,6,67,70.1894214876033,73,76.475041322314,64.4285714285714,67.4955844155844
68012,55,6,3,61,61.7259504132231,64,64.761652892562,58.75,59.449173553719
67443,39,6,3,45,46.0650887573964,48,49.1360946745562,42.75,43.7618343195266
67243,32,8,3,40,42.5,45,47.8125,39,41.4375
67888,45,9,2,54,56.16,61,63.44,57,59.28
68249,55,9,5,64,65.7137190082645,68,69.820826446281,61,62.6333884297521
67950,48,3,6,51,51.19921875,48,48.1875,48.4285714285714,48.6177455357143
68294,50,7,6,57,58.1172,58,59.1368,53,54.0388
67484,47,10,4,57,59.5803531009507,63,65.8519692168402,56,58.5350837483024
67542,50,8,8,58,59.4848,58,59.4848,53.1111111111111,54.4707555555556
68216,44,9,5,53,55.2174586776859,57,59.3848140495868,50,52.0919421487603
67397,42,9,8,51,53.3418367346939,52,54.3877551020408,46,48.1122448979592
67967,37,3,8,40,40.2629656683711,35,35.2300949598247,37.3333333333333,37.5787679571463
67492,31,5,4,36,36.9365244536941,37,37.9625390218522,33,33.8584807492196
67329,22,5,0,27,28.3946280991736,32,33.6528925619835,32,33.6528925619835
67460,49,14,2,63,68.1428571428572,75,81.1224489795918,79.3333333333333,85.8095238095238
67620,67,11,11,78,80.1024727110715,78,80.1024727110715,71.5833333333333,73.5128462166778
67461,39,6,3,45,46.0650887573964,48,49.1360946745562,42.75,43.7618343195266
68045,59,9,8,68,69.5823039356507,69,70.6055731111749,63,64.4659580580293
67529,49,14,4,63,68.1428571428572,73,78.9591836734694,67.2,72.6857142857143
67553,47,8,3,55,56.5934812132186,60,61.7383431416931,54,55.5645088275238
67501,37,8,4,45,47.1037253469686,49,51.290723155588,42.6,44.5915266617969
68279,59,9,5,68,69.5823039356507,72,73.6753806377478,65,66.5124964090779
67738,44,7,3,51,52.290805785124,55,56.3920454545455,49.25,50.4965134297521
67553,57,8,6,65,66.2803939673746,67,68.3197907048323,61,62.2016004924592
67450,46,8,8,54,55.6332703213611,54,55.6332703213611,49.1111111111111,50.5965133375341
67659,27,2,5,29,29.159122085048,26,26.1426611796982,27.1666666666667,27.3157293095565
67826,58,8,5,66,67.2556480380499,69,70.3127229488704,62.6666666666667,63.8588981371383
67635,50,11,5,61,63.9524,67,70.2428,59.1666666666667,62.0303333333333
67843,28,4,4,32,32.6530612244898,32,32.6530612244898,29.2,29.7959183673469
67483,16,3,0,19,19.66796875,22,22.7734375,19,19.66796875
67746,51,11,7,62,64.884275278739,66,69.0703575547866,57.875,60.5673779315648
67778,40,3,6,43,43.241875,40,40.225,40.4285714285714,40.6559821428571
67653,54,13,5,67,70.8830589849108,75,79.34670781893,67,70.8830589849108
67625,35,6,6,41,42.2048979591837,41,42.2048979591837,37.1428571428571,38.2344023323615
69520,62,10,10,72,73.8730489073881,72,73.8730489073881,66.0909090909091,67.8102355500899
68655,43,9,6,52,54.2779881016766,55,57.4094104921579,48.1428571428571,50.2518735996291
69068,59,12,9,71,73.9370870439529,74,77.0611893134157,65.6,68.3137029589198
68537,46,9,5,55,57.1053875236295,59,61.2585066162571,52,53.9905482041588
68904,38,8,5,46,48.0387811634349,49,51.1717451523546,42.6666666666667,44.5577100646353
68578,40,9,4,49,51.480625,54,56.73375,47.2,49.5895
69012,61,10,4,71,72.9080892233271,77,79.0693361999463,70,71.8812147272239
68718,60,9,8,69,70.5525,70,71.575,64,65.44
68494,46,11,8,57,60.2594517958412,60,63.4310018903592,52.1111111111111,55.0909997899601
68897,62,13,7,75,78.2973465140479,81,84.5611342351717,71.75,74.9044614984391
69096,82,12,13,94,96.0130874479477,93,94.9916716240333,86.7142857142857,88.5713435880003
68544,55,12,7,67,70.1894214876033,72,75.4274380165289,63.25,66.2609090909091
68761,65,7,9,72,72.8350295857988,70,70.8118343195266,67.1,67.878201183432
68703,61,14,4,75,78.9505509271701,85,89.4772910507928,79.2,83.3717817790916
69019,47,10,4,57,59.5803531009507,63,65.8519692168402,56,58.5350837483024
68773,59,15,11,74,78.783108302212,78,83.0416546969262,67.75,72.1291295604711
68755,51,6,6,57,57.7889273356401,57,57.7889273356401,53.1428571428571,53.8783984181908
68655,60,11,4,71,73.3863888888889,78,80.6216666666667,71,73.3863888888889
68553,56,10,8,66,68.1045918367347,68,70.1683673469388,61,62.9451530612245
68941,48,5,2,53,53.5750868055556,56,56.6076388888889,51.3333333333333,51.8903356481482
68558,53,13,6,66,69.9708081167675,73,77.3919544321823,64.1428571428571,68.0019325636983
68636,56,8,7,64,65.3061224489796,65,66.3265306122449,59.5,60.7142857142857
68407,50,10,6,60,62.4,64,66.56,56.4285714285714,58.6857142857143
68798,67,17,5,84,89.4078859434172,96,102.180441078191,89.6666666666667,95.439370312616
68320,39,9,6,48,50.5562130177515,51,53.7159763313609,44.1428571428571,46.4936601859679
68544,43,10,5,53,55.8664142779881,58,61.1368307193077,50.5,53.2312060573283
68574,50,7,7,57,58.1172,57,58.1172,52.625,53.65645
68416,40,8,4,48,49.92,52,54.08,45.6,47.424
68857,63,10,4,73,74.8392542202066,79,80.9904257999496,72,73.8140589569161
68516,49,8,5,57,58.5193669304456,60,61.5993336109954,53.6666666666667,55.0971817298348
68517,53,11,13,64,66.7568529725881,62,64.6707013171947,56.9285714285714,59.3808167624472
68718,61,9,6,70,71.5237839290513,73,74.5890889545821,66.1428571428571,67.5826774676546
68631,40,7,5,47,48.439375,49,50.500625,43.5,44.8321875
68591,48,9,6,57,59.00390625,60,62.109375,53.1428571428571,55.0111607142857
68445,41,7,7,48,49.3991671624033,48,49.3991671624033,43.625,44.8966389054134
68649,78,17,9,95,99.5126561472715,103,107.892669296515,91.6,95.9511505588429
68544,48,9,8,57,59.00390625,58,60.0390625,52,53.828125
68530,42,9,2,51,53.3418367346939,58,60.6632653061224,54,56.4795918367347
68587,49,11,6,60,63.0237401082882,65,68.2757184506456,56.8571428571429,59.7224965788064
68347,37,9,5,46,48.7216946676406,50,52.9583637691746,43,45.5441928414901
68786,62,9,8,71,72.4960978147763,72,73.5171696149844,66,67.3907388137357
68966,58,10,4,68,70.0214030915577,74,76.1997621878716,67,68.9916765755053
68923,65,12,11,77,79.6243786982249,78,80.6584615384615,70.5,72.9028402366864
68511,54,9,8,63,64.75,64,65.7777777777778,58,59.6111111111111
68789,60,8,9,68,69.2088888888889,67,68.1911111111111,62.8,63.9164444444444
68449,50,13,4,63,67.2588,72,76.8672,65.6,70.03456
68457,36,8,5,44,46.1728395061728,47,49.320987654321,40.6666666666667,42.6748971193416
68422,58,13,6,71,74.5668846611177,78,81.9185493460166,69.1428571428571,72.6164430100221
69051,43,8,1,51,52.7652785289346,58,60.007571660357,57,58.972958355868
70352,62,9,3,71,72.4960978147763,77,78.622528616025,71,72.4960978147763
68750,53,13,8,66,69.9708081167675,71,75.2716269134924,61.6666666666667,65.376765159606
69056,61,7,8,68,68.8954582101586,67,67.882289707068,63.3333333333333,64.1673385290693
69068,52,8,3,60,61.4201183431953,65,66.5384615384615,59,60.396449704142
69100,49,5,2,54,54.5622657226156,57,57.5935027072053,52.3333333333333,52.8782451756213
68894,54,12,8,66,69.2592592592593,70,73.4567901234568,61.3333333333333,64.3621399176955
68864,61,12,8,73,75.8250470303682,77,79.9798441279226,68.3333333333333,70.977783749888
69068,60,11,7,71,73.3863888888889,75,77.5208333333333,66.875,69.1227430555555
68799,64,8,9,72,73.125,71,72.109375,66.8,67.84375
69281,61,14,2,75,78.9505509271701,87,91.5826390755173,91.3333333333333,96.1442264624205
68772,59,15,9,74,78.783108302212,80,85.1709278942833,69.5,73.9922436081586
68640,55,10,8,65,67.1487603305785,67,69.2148760330578,60,61.9834710743802
68843,48,7,9,55,56.1697048611111,53,54.1271701388889,50.1,51.1654947916667
69214,76,11,9,87,88.8225415512465,89,90.8644390581717,81.5,83.2073234072022
68775,45,14,2,59,64.7106172839506,71,77.8720987654321,75.3333333333333,82.6248559670782
69120,58,8,5,66,67.2556480380499,69,70.3127229488704,62.6666666666667,63.8588981371383
69213,53,6,4,59,59.7561409754361,61,61.7817728729085,56,56.7176931292275
68692,47,10,10,57,59.5803531009507,57,59.5803531009507,51.0909090909091,53.4037614716655
68514,49,14,7,63,68.1428571428572,70,75.7142857142857,60.375,65.3035714285714
68874,64,11,5,75,77.215576171875,81,83.392822265625,73.1666666666667,75.3280843098958
68870,51,10,3,61,63.3452518262207,68,70.6143790849673,62.25,64.6433102652826
68826,54,6,6,60,60.7407407407407,60,60.7407407407407,56.1428571428571,56.8359788359788
69058,58,6,10,64,64.6848989298454,60,60.6420927467301,59.3636363636364,59.9989190357799
68894,53,9,5,62,63.7878248487006,66,67.9031683873264,59,60.7013171947312
68914,62,10,9,72,73.8730489073881,73,74.8990634755463,66.5,68.2299687825182
68468,34,6,5,40,41.2456747404844,41,42.2768166089965,36.5,37.636678200692
68911,53,6,4,59,59.7561409754361,61,61.7817728729085,56,56.7176931292275
68786,51,7,3,58,59.0926566705113,62,63.1680123029604,56.25,57.3096885813149
68604,41,6,3,47,48.0065437239738,50,51.0707911957168,44.75,45.7083581201666
68529,39,12,5,51,55.8284023668639,58,63.491124260355,50,54.7337278106509
68502,37,7,4,44,45.5748721694668,47,48.682249817385,41.2,42.6746530314098
68902,51,6,5,57,57.7889273356401,58,58.80276816609,53.5,54.2404844290657
68913,52,8,2,60,61.4201183431953,66,67.5621301775148,61.3333333333333,62.7850098619329
68743,38,3,5,41,41.255540166205,39,39.2430747922438,38.5,38.7399584487535
68499,37,10,5,47,50.4331628926224,52,55.7983929875822,44.5,47.7505478451424
68832,64,22,5,86,96.162109375,103,115.1708984375,102.5,114.61181640625
68668,46,7,10,53,54.2273156899811,50,51.1578449905482,47.9090909090909,49.0185169273071
68546,35,8,4,43,45.2465306122449,47,49.4555102040816,40.6,42.7211428571429
68885,44,9,7,53,55.2174586776859,55,57.3011363636364,48.5,50.5291838842975
69072,67,9,4,76,77.3713521942526,81,82.4615727333482,74.2,75.5388728001782
68965,55,6,6,61,61.7259504132231,61,61.7259504132231,57.1428571428571,57.8229043683589
69258,58,9,6,67,68.6132580261593,70,71.6854934601665,63.1428571428571,64.6632410395787
68930,51,8,7,59,60.4517493271819,60,61.4763552479816,54.5,55.8410226835832
69058,50,7,7,57,58.1172,57,58.1172,52.625,53.65645
68784,41,11,4,52,55.743010113028,59,63.2468768590125,52,55.743010113028
69157,48,7,5,55,56.1697048611111,57,58.2122395833333,51.5,52.5952690972222
68803,59,12,8,71,73.9370870439529,75,78.10255673657,66.3333333333333,69.0773724025663
68898,58,14,6,72,76.1950059453032,80,84.6611177170036,71,75.1367419738407
69243,54,11,5,65,67.6971879286694,71,73.946159122085,63.1666666666667,65.7877800640146
69340,62,7,5,69,69.8795525494277,71,71.9050468262227,65.5,66.3349375650364
68809,36,5,5,41,41.7908950617284,41,41.7908950617284,37.6666666666667,38.3932613168724
69151,65,9,6,74,75.4186982248521,77,78.4762130177515,70.1428571428571,71.4876077768385
68698,49,9,8,58,59.9566847147022,59,60.9904206580591,53,54.7880049979175
68623,41,8,5,49,50.8655562165378,52,53.9797739440809,45.6666666666667,47.4053142970454
68855,58,10,12,68,70.0214030915577,66,67.961950059453,61.4615384615385,63.2885758712156
69166,60,8,8,68,69.2088888888889,68,69.2088888888889,63.1111111111111,64.2330864197531
69153,30,8,6,38,40.7022222222222,40,42.8444444444444,34,36.4177777777778
69521,47,8,4,55,56.5934812132186,59,60.7093707559982,52.6,54.1239474875509
69339,40,8,5,48,49.92,51,53.04,44.6666666666667,46.4533333333333
69368,37,4,10,41,41.4791818845873,35,35.409057706355,37.5454545454545,37.9842619031808
69457,29,0,1,29,29,28,28,29,29
69621,52,10,10,62,64.292899408284,62,64.292899408284,56.0909090909091,58.1652770306616
69452,53,8,8,61,62.3898184407262,61,62.3898184407262,56.1111111111111,57.3895415529449
69448,59,10,9,69,70.9821890261419,70,72.0109164033324,63.5,65.3241884515944
69733,44,9,4,53,55.2174586776859,58,60.426652892562,51.2,53.3421487603306
69396,48,14,5,62,67.2743055555556,71,77.0399305555556,63.1666666666667,68.5402199074074
69837,50,9,6,59,60.9116,62,64.0088,55.1428571428571,56.9294857142857
69708,53,12,5,65,68.3321466714133,72,75.6909932360271,64,67.2808828764685
69603,41,9,2,50,52.4092801903629,57,59.7465794170137,53,55.5538370017847
69655,34,3,2,37,37.288062283737,38,38.2958477508651,35,35.272491349481
69774,48,4,5,52,52.3611111111111,51,51.3541666666667,49,49.3402777777778
69402,51,9,9,60,61.8685121107266,60,61.8685121107266,54.6,56.3003460207612
69451,57,10,9,67,69.0621729763004,68,70.0929516774392,61.5,63.3928901200369
69439,46,15,5,61,67.4862948960302,71,78.5496219281663,63.5,70.2521266540643
69425,39,10,3,49,52.2215647600263,56,59.6817882971729,50.25,53.5537475345168
69512,54,10,7,64,66.1947873799726,67,69.2976680384088,59.625,61.6697530864198
69494,50,13,10,63,67.2588,66,70.4616,57.0909090909091,60.9502545454546
69629,29,6,1,35,36.4982164090369,40,41.7122473246135,36.5,38.0624256837099
69733,51,6,4,57,57.7889273356401,59,59.8166089965398,54,54.7474048442907
69540,47,9,5,56,58.0534178361249,60,62.2000905387053,53,54.9434133091897
69651,61,5,10,66,66.4434291857028,61,61.4098360655738,61.9090909090909,62.3250348146881
69517,55,13,7,68,71.7990082644628,74,78.1342148760331,64.75,68.3674380165289
69665,55,10,5,65,67.1487603305785,70,72.3140495867768,62.5,64.5661157024793
69455,43,12,7,55,59.283396430503,60,64.6727961060032,51.25,55.2413466738778
69514,52,15,1,67,72.575073964497,81,87.7400147928994,104.5,113.195451183432
69655,59,13,10,72,75.4955472565355,75,78.6411950588911,66.0909090909091,69.2995743125016
70048,53,11,7,64,66.7568529725881,68,70.9291562833749,59.875,62.4541651833393
69652,45,1,7,46,46.0227160493827,40,40.0197530864197,45,45.0222222222222
69716,33,6,4,39,40.2892561983471,41,42.3553719008264,36,37.1900826446281
69403,41,11,6,52,55.743010113028,57,61.1029149315883,48.8571428571429,52.3739270842186
69553,37,7,4,44,45.5748721694668,47,48.682249817385,41.2,42.6746530314098
69766,47,6,7,53,53.8637392485287,52,52.8474422815754,48.875,49.6715142598461
69599,53,21,5,74,85.6176575293699,90,104.129583481666,88,101.815592737629
69640,44,8,5,52,53.7190082644628,55,56.8181818181818,48.6666666666667,50.2754820936639
69656,36,4,3,40,40.4938271604938,41,41.5061728395062,37.5,37.962962962963
69492,49,7,12,56,57.1428571428571,51,52.0408163265306,50.6153846153846,51.6483516483516
69482,34,7,4,41,42.7378892733564,44,45.8650519031142,38.2,39.8192041522491
69779,57,14,5,71,75.2831640504771,80,84.8261003385657,72.1666666666667,76.5202113470812
69961,52,8,6,60,61.4201183431953,62,63.4674556213018,56,57.3254437869822
70351,51,6,4,57,57.7889273356401,59,59.8166089965398,54,54.7474048442907
69656,52,9,10,61,62.8272928994083,60,61.7973372781065,55.2727272727273,56.9284561592254
69581,49,11,6,60,63.0237401082882,65,68.2757184506456,56.8571428571429,59.7224965788064
69634,42,12,3,54,58.4081632653061,63,68.1428571428572,58.5,63.2755102040816
69639,36,8,3,44,46.1728395061728,49,51.4197530864198,43,45.1234567901235
69536,54,12,11,66,69.2592592592593,67,70.3086419753086,59.5,62.4382716049383
69687,45,8,5,53,54.6750617283951,56,57.7698765432099,49.6666666666667,51.236378600823
69712,46,11,3,57,60.2594517958412,65,68.7169187145558,59.75,63.1667060491493
69870,52,5,5,57,57.5269970414201,57,57.5269970414201,53.6666666666667,54.1628451676529
69679,42,10,9,52,54.9478458049887,53,56.0045351473923,46.5,49.1360544217687
73071,62,11,5,73,75.297866805411,79,81.4867325702393,71.1666666666667,73.4068244883802
72770,58,9,8,67,68.6132580261593,68,69.6373365041617,62,63.4928656361474
73344,58,8,2,66,67.2556480380499,72,73.3697978596908,67.3333333333333,68.6143479984146
72932,58,12,4,70,72.9964328180737,78,81.3388822829964,71.2,74.2478002378121
72473,59,14,4,73,77.1103131284114,83,87.6733697213444,77.2,81.5467968974433
72992,63,9,4,72,73.469387755102,77,78.5714285714286,70.2,71.6326530612245
72743,63,15,3,78,82.421768707483,90,95.1020408163265,89.25,94.3095238095238
72558,61,9,9,70,71.5237839290513,70,71.5237839290513,64.6,66.0062348830959
72575,62,19,7,81,88.6069198751301,93,101.733870967742,83.375,91.2049622788762
72402,54,9,8,63,64.75,64,65.7777777777778,58,59.6111111111111
72489,58,15,6,73,77.8825802615933,82,87.4845422116528,73,77.8825802615933
72760,70,20,5,90,97.3469387755102,105,113.571428571429,101.666666666667,109.965986394558
72371,55,9,7,64,65.7137190082645,66,67.7672727272727,59.5,61.0932231404959
72637,55,9,6,64,65.7137190082645,67,68.7940495867769,60.1428571428571,61.7532939787485
73165,73,8,6,81,81.9727903921937,83,83.9968099080503,77,77.9247513604804
73031,76,10,4,86,87.48891966759,92,93.5927977839335,85,86.4716066481994
73012,66,12,8,78,80.5785123966942,82,84.7107438016529,73.3333333333333,75.7575757575758
73142,77,14,6,91,94.0082644628099,99,102.272727272727,90,92.9752066115702
72690,60,10,9,70,71.9444444444444,71,72.9722222222222,64.5,66.2916666666667
73094,69,14,3,83,86.4169292165512,94,97.8697752572989,91.75,95.527147658055
72600,56,5,10,61,61.4862882653061,56,56.4464285714286,56.9090909090909,57.3627666975881
72929,71,11,5,82,83.9682602658203,88,90.1122793096608,80.1666666666667,82.0909211135357
73072,63,7,9,70,70.8641975308642,68,68.8395061728395,65.1,65.9037037037037
72621,65,13,8,78,81.12,83,86.32,73.6666666666667,76.6133333333333
72651,66,11,11,77,79.1388888888889,77,79.1388888888889,70.5833333333333,72.5439814814815
72890,76,18,5,94,99.2728531855956,107,113.002077562327,101.5,107.193559556787
72957,80,16,9,96,99.84,103,107.12,92,95.68
73150,62,8,9,70,71.165452653486,69,70.1488033298647,64.8,65.8788761706556
72833,59,7,8,66,66.9290433783396,65,65.9149669635162,61.3333333333333,62.1966867758307
72940,69,10,8,79,80.6593152699013,81,82.7013232514178,74,75.5542953161101
72687,66,15,8,81,85.1838842975207,88,92.5454545454545,77.6666666666667,81.6783746556474
72638,61,5,12,66,66.4434291857028,59,59.3963988175222,61.7692307692308,62.1842350071321
72485,57,12,4,69,72.0581717451524,77,80.4127423822715,70.2,73.3113573407202
73121,62,9,5,71,72.4960978147763,75,76.5803850156087,68,69.4328824141519
72575,58,9,8,67,68.6132580261593,68,69.6373365041617,62,63.4928656361474
73132,57,8,5,65,66.2803939673746,68,69.3394890735611,61.6666666666667,62.8813994049451
73176,71,8,10,79,80.0029756000793,77,77.9775838127356,73.5454545454545,74.4791798164145
73123,66,9,8,75,76.3946280991736,76,77.4132231404959,70,71.301652892562
72897,56,11,9,67,69.5851403061225,69,71.6623086734694,61.5,63.8729272959184
72596,65,18,9,83,89.3649704142012,92,99.0551479289941,80.3,86.4579171597633
73059,67,10,11,77,78.7153040766318,76,77.6930274003119,70.75,72.3260748496324
73025,67,12,6,79,81.534194698151,85,87.7266651815549,76.4285714285714,78.8802787766922
72938,66,12,7,78,80.5785123966942,83,85.7438016528926,74.25,76.7045454545455
72921,72,13,14,85,87.7710262345679,84,86.7384259259259,77.2,79.7167438271605
73035,64,11,9,75,77.215576171875,77,79.274658203125,69.5,71.5531005859375
72507,64,13,5,77,80.177001953125,85,88.507080078125,77,80.177001953125
72957,51,9,7,60,61.8685121107266,62,63.9307958477509,55.5,57.2283737024221
72520,63,12,8,75,77.7210884353741,79,81.8662131519274,70.3333333333333,72.8851095993953
73105,57,9,8,66,67.6454293628809,67,68.6703601108033,61,62.5207756232687
72647,63,9,7,72,73.469387755102,74,75.5102040816327,67.5,68.8775510204082
72824,67,11,9,78,80.1024727110715,80,82.1563822677657,72.5,74.4542214301626
72738,57,13,4,70,73.6411203447214,79,83.1092643890428,72.6,76.3763619575254
72734,53,9,6,62,63.7878248487006,65,66.87433250267,58.1428571428571,59.8194578650257
72848,57,10,4,67,69.0621729763004,73,75.2468451831333,66,68.0313942751616
73807,61,8,8,69,70.1867777479172,69,70.1867777479172,64.1111111111111,65.2138015467766
73060,52,9,2,61,62.8272928994083,68,70.0369822485207,64,65.9171597633136
73148,60,11,4,71,73.3863888888889,78,80.6216666666667,71,73.3863888888889
72929,72,14,7,86,89.2515432098765,93,96.5162037037037,83.375,86.5272955246914
73465,62,9,7,71,72.4960978147763,73,74.5382414151925,66.5,67.9012747138397
73748,46,3,8,49,49.2084120982987,44,44.187145557656,46.3333333333333,46.5304032766226
72818,55,8,2,63,64.3328925619835,69,70.4598347107438,64.3333333333333,65.694435261708
72793,45,4,5,49,49.3871604938272,48,48.3792592592593,46,46.3634567901235
72839,64,12,3,76,78.671875,85,87.98828125,80.5,83.330078125
72609,55,10,8,65,67.1487603305785,67,69.2148760330578,60,61.9834710743802
72623,55,15,7,70,75.2066115702479,78,83.801652892562,68.125,73.1921487603306
73365,57,5,5,62,62.4770698676516,62,62.4770698676516,58.6666666666667,59.1180876167026
72828,66,16,9,82,86.8191000918274,89,94.2304866850321,78,82.5840220385675
72820,63,10,4,73,74.8392542202066,79,80.9904257999496,72,73.8140589569161
72856,76,15,9,91,94.5448407202216,97,100.778566481994,86.5,89.869546398892
72597,53,14,7,67,71.6749733001068,74,79.1634033463866,64.375,68.8668120327519
72895,52,7,6,59,60.0691568047337,60,61.0872781065089,55,55.9966715976331
72975,44,6,5,50,50.9297520661157,51,51.948347107438,46.5,47.3646694214876
72648,64,11,10,75,77.215576171875,76,78.2451171875,69,71.038330078125
72701,65,13,5,78,81.12,86,89.44,78,81.12
73279,54,7,3,61,62.0250342935528,65,66.0922496570645,59.25,60.2456275720165
72880,51,9,5,60,61.8685121107266,64,65.9930795847751,57,58.7750865051903
73360,51,5,3,56,56.5382545174933,58,58.557477893118,53.5,54.0142252979623
73295,42,10,7,52,54.9478458049887,55,58.1179138321995,47.625,50.3248299319728
73289,50,5,7,55,55.55,53,53.53,51.25,51.7625
72888,45,6,4,51,51.9066666666667,53,53.9422222222222,48,48.8533333333333
72941,42,5,5,47,47.6660997732426,47,47.6660997732426,43.6666666666667,44.2855253212396
73513,55,9,3,64,65.7137190082645,70,71.8743801652893,64,65.7137190082645
73088,70,14,5,84,87.36,93,96.72,85.1666666666667,88.5733333333333
73368,69,5,6,74,74.3885738290275,73,73.3833228313379,70.4285714285714,70.7983916944219
73376,62,9,4,71,72.4960978147763,76,77.6014568158169,69.2,70.6581685744017
72607,48,12,5,60,63.75,67,71.1875,59,62.6875
72894,55,10,4,65,67.1487603305785,71,73.3471074380165,64,66.1157024793388
73242,58,5,7,63,63.468192627824,61,61.4533293697979,59.25,59.690324019025
73061,50,11,1,61,63.9524,71,74.4364,77.5,81.251
73024,28,3,3,31,31.3558673469388,31,31.3558673469388,28.75,29.0800382653061
76901,61,10,3,71,72.9080892233271,78,80.0962106960495,72.25,74.1916823434561
76718,57,13,8,70,73.6411203447214,75,78.9012003693444,65.6666666666667,69.0823843233816
76640,61,9,8,70,71.5237839290513,71,72.5455522708949,65,66.4149422198334
76833,46,12,7,58,61.9470699432892,63,67.2873345935728,54.25,57.9418714555766
76782,52,11,7,63,65.8191568047337,67,69.998150887574,58.875,61.5095691568047
76637,68,16,13,84,88.6505190311419,87,91.8166089965398,76.5714285714286,80.8106772120613
76832,47,6,8,53,53.8637392485287,51,51.831145314622,48.6666666666667,49.4597857250641
76707,58,10,5,68,70.0214030915577,73,75.1700356718192,65.5,67.4470868014269
76610,58,10,9,68,70.0214030915577,69,71.05112960761,62.5,64.3579072532699
76640,63,12,7,75,77.7210884353741,80,82.9024943310658,71.25,73.8350340136054
76781,67,14,6,81,84.5366451325462,89,92.8859434172421,80,83.4929828469592
76627,57,11,8,68,70.5324715297015,71,73.6441982148353,63.1111111111111,65.4615095242981
76464,45,6,6,51,51.9066666666667,51,51.9066666666667,47.1428571428571,47.9809523809524
76654,41,5,5,46,46.6841165972635,46,46.6841165972635,42.6666666666667,43.3012095974618
76785,30,7,3,37,39.0144444444445,41,43.2322222222222,35.25,37.1691666666667
76724,58,10,11,68,70.0214030915577,67,68.9916765755053,61.75,63.5856123662307
76918,36,5,6,41,41.7908950617284,40,40.7716049382716,37.4285714285714,38.1505731922399
76371,45,9,9,54,56.16,54,56.16,48.6,50.544
76416,37,8,7,45,47.1037253469686,46,48.1504747991234,40.5,42.3933528122717
76687,64,16,6,80,85,90,95.625,81.1428571428571,86.2142857142857
76829,53,10,5,63,65.2427910288359,68,70.4207903168387,60.5,62.6537913848345
76803,58,5,8,63,63.468192627824,60,60.4458977407848,59.1111111111111,59.5504029594398
76729,44,11,3,55,58.4375,63,66.9375,57.75,61.359375
76551,51,10,5,61,63.3452518262207,66,68.5374855824683,58.5,60.7491349480969
76703,54,7,8,61,62.0250342935528,60,61.0082304526749,56.3333333333333,57.2799497027892
76593,29,4,2,33,33.627824019025,35,35.6658739595719,31,31.589774078478
76798,43,7,2,50,51.3250405624662,55,56.4575446187128,50,51.3250405624662
76760,58,15,4,73,77.8825802615933,84,89.6183115338882,79,84.2838882282996
76641,48,13,5,61,65.4743923611111,69,74.0611979166667,61,65.4743923611111
76762,62,11,7,73,75.297866805411,77,79.4237773152966,68.875,71.0430215920916
76649,52,13,6,65,69.0625,72,76.5,63.1428571428571,67.0892857142857
76785,44,8,5,52,53.7190082644628,55,56.8181818181818,48.6666666666667,50.2754820936639
76738,53,10,6,63,65.2427910288359,67,69.3851904592382,59.4285714285714,61.5442201088339
77119,70,5,13,75,75.3826530612245,67,67.3418367346939,70.7142857142857,71.0750728862974
76659,53,7,7,60,61.0466358134567,60,61.0466358134567,55.625,56.5953186187255
76996,60,10,4,70,71.9444444444444,76,78.1111111111111,69,70.9166666666667
77026,60,14,8,74,78.0288888888889,80,84.3555555555556,70.1111111111111,73.9282716049383
76739,52,9,8,61,62.8272928994083,62,63.8572485207101,56,57.6775147928994
76730,55,9,4,64,65.7137190082645,69,70.8476033057851,62.2,63.865520661157
76786,63,13,8,76,79.236079617032,81,84.4489795918367,71.6666666666667,74.7182329722012
76818,59,7,7,66,66.9290433783396,66,66.9290433783396,61.625,62.4924590634875
76722,38,7,8,45,46.5270083102493,44,45.4930747922438,40.3333333333333,41.7019852262235
76865,59,11,12,70,72.4332088480322,69,71.3984487216317,63.2307692307692,65.4286787616291
76924,58,15,10,73,77.8825802615933,78,83.2170035671819,67.5454545454545,72.0632093827694
76965,59,10,6,69,70.9821890261419,73,75.0970985349038,65.4285714285714,67.3081626790331
77070,70,14,10,84,87.36,88,91.52,78.2727272727273,81.4036363636364
76883,41,8,5,49,50.8655562165378,52,53.9797739440809,45.6666666666667,47.4053142970454
76986,59,10,8,69,70.9821890261419,71,73.0396437805228,64,65.8385521401896
77076,44,7,7,51,52.290805785124,51,52.290805785124,46.625,47.8050748966942
76985,69,10,10,79,80.6593152699013,79,80.6593152699013,73.0909090909091,74.6261098699662
77260,53,7,3,60,61.0466358134567,64,65.1164115343539,58.25,59.2661089355643
76963,51,10,4,61,63.3452518262207,67,69.5759323337178,60,62.3068050749712
77127,63,13,7,76,79.236079617032,82,85.4915595867977,72.75,75.8476946334089
77013,53,11,7,64,66.7568529725881,68,70.9291562833749,59.875,62.4541651833393
76979,38,6,4,44,45.0969529085873,46,47.1468144044321,41,42.0221606648199
76820,50,17,5,67,74.7452,79,88.1324,72.6666666666667,81.0669333333333
77298,55,16,6,71,77.0085950413223,81,87.8548760330578,72.1428571428571,78.2481700118064
79601,32,6,3,38,39.3359375,41,42.44140625,35.75,37.0068359375
79427,32,6,3,38,39.3359375,41,42.44140625,35.75,37.0068359375
79363,27,7,4,34,36.2853223593964,37,39.4869684499314,31.2,33.2971193415638
79676,41,2,6,43,43.1023200475907,39,39.0928019036288,41.1428571428571,41.2407580521798
79993,52,8,9,60,61.4201183431953,59,60.396449704142,54.8,56.0970414201183
79612,56,11,9,67,69.5851403061225,69,71.6623086734694,61.5,63.8729272959184
79656,33,4,8,37,37.5436179981635,33,33.4848484848485,33.6666666666667,34.161310070401
79438,32,11,3,43,48.0810546875,51,57.0263671875,45.75,51.156005859375
79588,34,3,9,37,37.288062283737,31,31.2413494809689,34.3,34.5670415224914
79778,38,9,2,47,49.6364265927978,54,57.0290858725762,50,52.8047091412742
79340,32,9,5,41,44.2431640625,45,48.5595703125,38,41.005859375
79519,33,7,5,40,41.7998163452709,42,43.8898071625344,36.5,38.1423324150597
79721,25,4,4,29,29.7424,29,29.7424,26.2,26.87072
79827,30,4,1,34,34.6044444444444,37,37.6577777777778,33,33.5866666666667
79714,47,7,7,54,55.1978270710729,54,55.1978270710729,49.625,50.7257808963332
79719,43,7,2,50,51.3250405624662,55,56.4575446187128,50,51.3250405624662
79409,31,5,4,36,36.9365244536941,37,37.9625390218522,33,33.8584807492196
79751,39,7,4,46,47.4819197896121,49,50.5785667324129,43.2,44.5917159763314
79817,57,14,2,71,75.2831640504771,83,88.0070791012619,87.3333333333333,92.6018262029342
79731,40,5,4,45,45.703125,46,46.71875,42,42.65625
79686,44,9,3,53,55.2174586776859,59,61.4684917355372,53,55.2174586776859
79765,44,5,4,49,49.6327479338843,50,50.6456611570248,46,46.5940082644628
80086,26,3,7,29,29.3860946745562,25,25.3328402366864,26.375,26.7261464497041
80260,39,7,8,46,47.4819197896121,45,46.4497041420118,41.3333333333333,42.6649134341442
80422,43,3,9,46,46.2239048134127,40,40.1946998377501,43.3,43.5107625743645
80413,50,12,4,62,65.5712,70,74.032,63.2,66.84032
80478,47,9,4,56,58.0534178361249,61,63.2367587143504,54.2,56.1874151199638
80281,41,11,3,52,55.743010113028,60,64.3188578227246,54.75,58.6909577632362
80400,43,8,3,51,52.7652785289346,56,57.9383450513791,50,51.7306652244457
81003,58,6,4,64,64.6848989298454,66,66.7063020214031,61,61.6527942925089
80770,49,5,3,54,54.5622657226156,56,56.5830903790087,51.5,52.0362349021241
80361,40,11,1,51,54.856875,61,65.613125,67.5,72.6046875
80591,57,10,5,67,69.0621729763004,72,74.2160664819945,64.5,66.4852262234534
80970,55,5,1,60,60.495867768595,64,64.5289256198347,60,60.495867768595
80713,55,6,6,61,61.7259504132231,61,61.7259504132231,57.1428571428571,57.8229043683589
80355,45,6,7,51,51.9066666666667,50,50.8888888888889,46.875,47.7083333333333
80603,48,4,4,52,52.3611111111111,52,52.3611111111111,49.2,49.5416666666667
80690,49,5,5,54,54.5622657226156,54,54.5622657226156,50.6666666666667,51.194224628627
80438,44,10,4,54,56.7892561983471,60,63.099173553719,53,55.7376033057851
80592,40,5,7,45,45.703125,43,43.671875,41.25,41.89453125
80450,54,12,8,66,69.2592592592593,70,73.4567901234568,61.3333333333333,64.3621399176955
80664,49,8,3,57,58.5193669304456,62,63.6526447313619,56,57.4927113702624
80530,46,5,4,51,51.6025519848771,52,52.6143667296786,48,48.5671077504726
80747,52,8,3,60,61.4201183431953,65,66.5384615384615,59,60.396449704142
80487,40,5,6,45,45.703125,44,44.6875,41.4285714285714,42.0758928571429
81069,54,8,3,62,63.360768175583,67,68.4705075445816,61,62.3388203017833
81843,44,11,5,55,58.4375,61,64.8125,53.1666666666667,56.4895833333333
81494,42,9,10,51,53.3418367346939,50,52.2959183673469,45.2727272727273,47.3515769944341
81761,42,6,5,48,48.9795918367347,49,50,44.5,45.4081632653061
82473,38,3,4,41,41.255540166205,40,40.2493074792244,38.6,38.8405817174515
81557,34,6,3,40,41.2456747404844,43,44.3391003460208,37.75,38.9256055363322
82088,24,4,3,28,28.7777777777778,29,29.8055555555556,25.5,26.2083333333333
81994,40,4,1,44,44.44,47,47.47,43,43.43
81821,41,2,4,43,43.1023200475907,41,41.0975609756098,41.2,41.2980368828079
81933,34,6,1,40,41.2456747404844,45,46.401384083045,41.5,42.7923875432526
82191,39,5,2,44,44.7232084155161,47,47.7725180802104,42.3333333333333,43.029147490686
82351,36,4,6,40,40.4938271604938,38,38.4691358024691,36.8571428571429,37.3121693121693
81745,45,6,3,51,51.9066666666667,54,54.96,48.75,49.6166666666667
81696,41,6,1,47,48.0065437239738,52,53.1136228435455,48.5,49.5386674598453
81786,44,3,4,47,47.2184917355372,46,46.2138429752066,44.6,44.8073347107438
82037,37,3,1,40,40.2629656683711,42,42.2761139517896,38.5,38.7531044558072
81853,35,7,4,42,43.68,45,46.8,39.2,40.768
81714,33,6,3,39,40.2892561983471,42,43.3884297520661,36.75,37.9648760330578
81464,17,0,4,17,17,13,13,17,17
81689,22,0,2,22,22,20,20,22,22
81761,20,0,3,20,20,17,17,20,20
81516,19,0,1,19,19,18,18,19,19
81575,43,5,5,48,48.6489994591671,48,48.6489994591671,44.6666666666667,45.2705967189472
81968,20,4,1,24,24.96,27,28.08,23,23.92
81702,17,2,1,19,19.2629757785467,20,20.2768166089965,17.5,17.742214532872
81509,25,6,6,31,32.7856,31,32.7856,27.1428571428571,28.7062857142857
81714,25,6,4,31,32.7856,33,34.9008,28,29.6128
82169,28,6,1,34,35.5612244897959,39,40.7908163265306,35.5,37.1301020408163
81828,29,5,4,34,35.0107015457788,35,36.0404280618312,31,31.9215219976219
81505,41,15,5,56,63.4955383700178,66,74.8340273646639,58.5,66.3301606186794
81413,20,2,3,22,22.22,21,21.21,20.25,20.4525
81694,27,1,3,28,28.0384087791495,26,26.0356652949246,27,27.037037037037
81673,19,1,2,20,20.0554016620499,19,19.0526315789474,19,19.0526315789474
81927,16,0,1,16,16,15,15,16,16
81411,23,7,2,30,32.7788279773157,35,38.241965973535,30,32.7788279773157
81516,43,4,7,47,47.4067063277447,44,44.380746349378,43.75,44.1285830178475
82402,37,3,2,40,40.2629656683711,41,41.2695398100804,38,38.2498173849525
82072,32,5,2,37,37.9033203125,40,40.9765625,35.3333333333333,36.1959635416667
82157,43,4,7,47,47.4067063277447,44,44.380746349378,43.75,44.1285830178475
82162,42,1,3,43,43.0243764172336,41,41.0232426303855,42,42.0238095238095
82148,42,6,5,48,48.9795918367347,49,50,44.5,45.4081632653061
83418,61,6,8,67,67.6482128460091,65,65.6288632088148,62.6666666666667,63.2729552987548
83995,53,8,8,61,62.3898184407262,61,62.3898184407262,56.1111111111111,57.3895415529449
82738,55,8,3,63,64.3328925619835,68,69.4386776859504,62,63.3117355371901
82607,46,8,7,54,55.6332703213611,55,56.6635160680529,49.5,50.9971644612476
82725,55,7,2,62,63.0042975206612,67,68.0852892561984,62,63.0042975206612
83156,70,8,5,78,79.0187755102041,81,82.0579591836735,74.6666666666667,75.6419047619048
82623,57,8,6,65,66.2803939673746,67,68.3197907048323,61,62.2016004924592
82586,50,8,4,58,59.4848,62,63.5872,55.6,57.02336
82785,49,6,3,55,55.8246563931695,58,58.8696376509788,52.75,53.5409204498126
82610,39,7,5,46,47.4819197896121,48,49.5463510848126,42.5,43.8691650230112
82702,60,6,5,66,66.66,67,67.67,62.5,63.125
82989,70,5,5,75,75.3826530612245,75,75.3826530612245,71.6666666666667,72.0323129251701
83119,71,10,3,81,82.6068240428486,88,89.7456853798849,82.25,83.8816207101766
83060,58,3,2,61,61.1631985731272,62,62.1658739595719,59,59.1578478002378
82711,64,6,7,70,70.615234375,69,69.6064453125,65.875,66.4539794921875
82793,53,8,7,61,62.3898184407262,62,63.4126023495906,56.5,57.7872908508366
82741,52,4,11,56,56.3313609467456,49,49.2899408284024,52.5,52.810650887574
82537,58,10,8,68,70.0214030915577,70,72.0808561236623,63,64.8727705112961
82772,49,3,5,52,52.1949187838401,50,50.1874219075385,49.5,49.6855476884631
82848,58,11,8,69,71.4818668252081,72,74.589774078478,64.1111111111111,66.4171290791386
82735,70,10,8,80,81.6326530612245,82,83.6734693877551,75,76.530612244898
82795,64,10,4,74,75.806640625,80,81.953125,73,74.7822265625
83380,62,9,8,71,72.4960978147763,72,73.5171696149844,66,67.3907388137357
82802,59,5,7,64,64.4596380350474,62,62.4452743464522,60.25,60.6827061189313
82770,61,5,6,66,66.4434291857028,65,65.436710561677,62.4285714285714,62.8480055284678
82699,48,6,7,54,54.84375,53,53.828125,49.875,50.654296875
82995,62,9,5,71,72.4960978147763,75,76.5803850156087,68,69.4328824141519
82434,55,5,15,60,60.495867768595,50,50.4132231404959,55.625,56.0847107438017
82828,59,5,2,64,64.4596380350474,67,67.4811835679402,62.3333333333333,62.7810016278847
82644,56,12,3,68,71.1224489795918,77,80.5357142857143,72.5,75.8290816326531
82925,57,4,4,61,61.3004001231148,61,61.3004001231148,58.2,58.4866112650046
82463,46,8,7,54,55.6332703213611,55,56.6635160680529,49.5,50.9971644612476
82617,55,13,0,68,71.7990082644628,81,85.5252892561983,133,140.43041322314
84667,35,6,4,41,42.2048979591837,43,44.2636734693878,38,39.1167346938775
83849,46,7,3,53,54.2273156899811,57,58.319943289225,51.25,52.4367911153119
83877,46,8,5,54,55.6332703213611,57,58.7240075614367,50.6666666666667,52.1991178323882
83983,34,2,7,36,36.1245674740484,31,31.1072664359862,34.125,34.2430795847751
83341,23,4,5,27,27.8166351606805,26,26.7863894139887,24,24.7258979206049
83662,49,5,7,54,54.5622657226156,52,52.5414410662224,50.25,50.7732194918784
83578,45,1,6,46,46.0227160493827,41,41.0202469135802,45,45.0222222222222
84078,47,5,3,52,52.5885015844273,54,54.6111362607515,49.5,50.0602082390222
83716,31,1,5,32,32.0332986472425,28,28.0291363163371,31,31.0322580645161
84872,31,1,4,32,32.0332986472425,29,29.0301768990635,31,31.0322580645161
83865,48,4,9,52,52.3611111111111,47,47.3263888888889,48.6,48.9375
83768,55,10,2,65,67.1487603305785,73,75.4132231404959,70,72.3140495867768
84018,60,13,7,73,76.4269444444444,79,82.7086111111111,69.75,73.024375
83683,45,7,5,52,53.2582716049383,54,55.3066666666667,48.5,49.6735802469136
83648,35,8,2,43,45.2465306122449,49,51.56,44.3333333333333,46.6495238095238
83247,29,4,4,33,33.627824019025,33,33.627824019025,30.2,30.7745541022592
83349,31,5,3,36,36.9365244536941,38,38.9885535900104,33.5,34.3714880332986
83851,35,1,4,36,36.029387755102,33,33.0269387755102,35,35.0285714285714
84067,34,7,2,41,42.7378892733564,46,47.9498269896194,41,42.7378892733564
83612,33,4,3,37,37.5436179981635,38,38.5583103764922,34.5,35.0068870523416
83824,35,7,2,42,43.68,47,48.88,42,43.68
83697,35,5,3,40,40.8163265306122,42,42.8571428571429,37.5,38.265306122449
83371,39,11,4,50,53.9776462853386,57,61.534516765286,50,53.9776462853386
83604,35,3,6,38,38.2791836734694,35,35.2571428571429,35.4285714285714,35.6888629737609
83868,51,4,2,55,55.3383314109958,57,57.3506343713956,53,53.3260284505959
83767,42,5,4,47,47.6660997732426,48,48.6802721088435,44,44.6235827664399
83634,41,5,4,46,46.6841165972635,47,47.698988697204,43,43.639500297442
83435,31,10,4,41,45.2663891779396,47,51.8907388137357,40,44.162330905307
83621,50,11,7,61,63.9524,65,68.146,56.875,59.62775
83377,46,13,4,59,63.7121928166352,68,73.4310018903592,61.6,66.5198487712665
83388,35,10,6,45,48.6734693877551,49,53,41.4285714285714,44.8104956268222
83638,41,7,5,48,49.3991671624033,50,51.4574657941701,44.5,45.7971445568114
84030,52,10,5,62,64.292899408284,67,69.4778106508876,59.5,61.7004437869822
83398,32,5,3,37,37.9033203125,39,39.9521484375,34.5,35.34228515625
83773,38,2,4,40,40.1108033240997,38,38.1052631578947,38.2,38.3058171745152
83837,41,7,3,48,49.3991671624033,52,53.5157644259369,46.25,47.5981558596074
83518,43,9,1,52,54.2779881016766,60,62.6284478096268,61,63.6722552731206
83980,34,5,6,39,39.8434256055363,38,38.8217993079585,35.4285714285714,36.194760257044
83682,54,12,7,66,69.2592592592593,71,74.5061728395062,62.25,65.3240740740741
83749,53,10,11,63,65.2427910288359,62,64.2071911712353,56.75,58.7702919188323
83694,53,14,5,67,71.6749733001068,76,81.3029547881808,68.1666666666667,72.9230449744868
83716,47,7,4,54,55.1978270710729,57,58.2643730194658,51.2,52.3357175192395
83568,42,6,4,48,48.9795918367347,50,51.0204081632653,45,45.9183673469388
83613,38,5,3,43,43.744459833795,45,45.7790858725762,40.5,41.2011772853186
83446,32,9,5,41,44.2431640625,45,48.5595703125,38,41.005859375
83781,39,12,5,51,55.8284023668639,58,63.491124260355,50,54.7337278106509
83615,50,8,9,58,59.4848,57,58.4592,52.8,54.15168
83279,33,6,8,39,40.2892561983471,37,38.2231404958678,34.6666666666667,35.8126721763085
83780,38,7,5,45,46.5270083102493,47,48.5948753462604,41.5,42.9082409972299
84113,49,8,2,57,58.5193669304456,63,64.6793002915452,58.3333333333333,59.88824101069
83841,43,2,5,45,45.0973499188751,42,42.0908599242834,43.1666666666667,43.2600504777357
84133,48,7,5,55,56.1697048611111,57,58.2122395833333,51.5,52.5952690972222
84704,50,7,7,57,58.1172,57,58.1172,52.625,53.65645
83656,35,1,8,36,36.029387755102,29,29.0236734693878,35,35.0285714285714
83603,49,13,3,62,66.3640149937526,72,77.0678883798417,68.5,73.3215326947105
83551,31,3,4,34,34.318418314256,33,33.309053069719,31.6,31.8959417273673
83314,30,5,2,35,35.9722222222222,38,39.0555555555556,33.3333333333333,34.2592592592593
83633,36,4,7,40,40.4938271604938,37,37.4567901234568,36.75,37.2037037037037
84199,51,6,4,57,57.7889273356401,59,59.8166089965398,54,54.7474048442907
83529,22,3,3,25,25.4648760330579,25,25.4648760330579,22.75,23.1730371900826
83660,35,5,7,40,40.8163265306122,38,38.7755102040816,36.25,36.9897959183673
83397,30,4,5,34,34.6044444444444,33,33.5866666666667,31,31.5511111111111
83496,31,4,1,35,35.582726326743,38,38.6326742976067,34,34.5660770031217
84298,35,4,2,39,39.509387755102,41,41.5355102040816,37,37.4832653061224
84681,32,3,2,35,35.3076171875,36,36.31640625,33,33.2900390625
83820,34,9,2,43,46.0129757785467,50,53.5034602076124,46,49.2231833910035
83791,21,2,4,23,23.2086167800454,21,21.1904761904762,21.2,21.3922902494331
84148,19,2,1,21,21.2326869806094,22,22.2437673130194,19.5,19.7160664819945
83534,26,3,2,29,29.3860946745562,30,30.3994082840237,27,27.3594674556213
83415,28,6,6,34,35.5612244897959,34,35.5612244897959,30.1428571428571,31.5269679300292
83795,31,3,6,34,34.318418314256,31,31.2903225806452,31.4285714285714,31.7229076854467
83874,41,3,7,44,44.2355740630577,40,40.2141582391434,41.375,41.5965199286139
83482,27,3,2,30,30.3703703703704,31,31.3827160493827,28,28.3456790123457
83429,30,2,7,32,32.1422222222222,27,27.12,30.125,30.2588888888889
83588,35,9,4,44,46.909387755102,49,52.24,42.2,44.9903673469388
83602,45,8,5,53,54.6750617283951,56,57.7698765432099,49.6666666666667,51.236378600823
83751,41,5,5,46,46.6841165972635,46,46.6841165972635,42.6666666666667,43.3012095974618
83910,53,11,6,64,66.7568529725881,69,71.9722321110715,60.8571428571429,63.4786146569699
83801,50,7,6,57,58.1172,58,59.1368,53,54.0388
83706,57,12,9,69,72.0581717451524,72,75.191135734072,63.6,66.418836565097
83553,42,10,6,52,54.9478458049887,56,59.1746031746032,48.4285714285714,51.1739552964043
83694,26,6,2,32,33.7041420118343,36,37.9171597633136,31,32.6508875739645
83669,43,15,3,58,65.0578691184424,70,78.5181179015684,69.25,77.676852352623
83800,31,3,4,34,34.318418314256,33,33.309053069719,31.6,31.8959417273673
84073,47,3,5,50,50.2037120869172,48,48.1955636034405,47.5,47.6935264825713
83728,37,5,5,42,42.7669831994156,42,42.7669831994156,38.6666666666667,39.372778183589
83540,34,7,5,41,42.7378892733564,43,44.8226643598616,37.5,39.0895328719723
84221,39,3,2,42,42.2485207100592,43,43.2544378698225,40,40.2366863905325
85531,29,2,5,31,31.1474435196195,28,28.1331747919144,29.1666666666667,29.3053904082442
84076,51,9,1,60,61.8685121107266,68,70.1176470588235,69,71.1487889273356
83854,47,4,5,51,51.3693979176098,50,50.3621548211861,48,48.3476686283386
83764,38,5,4,43,43.744459833795,44,44.7617728531856,40,40.6925207756233
83819,29,5,2,34,35.0107015457788,37,38.0998810939358,32.3333333333333,33.2944906856916
83932,35,6,4,41,42.2048979591837,43,44.2636734693878,38,39.1167346938775
84420,56,4,7,60,60.3061224489796,57,57.2908163265306,56.75,57.0395408163265
83653,41,12,2,53,57.5401546698394,63,68.3967876264129,63,68.3967876264129
83717,33,6,4,39,40.2892561983471,41,42.3553719008264,36,37.1900826446281
83886,39,6,8,45,46.0650887573964,43,44.0177514792899,40.6666666666667,41.629191321499
84021,53,5,5,58,58.5161979352083,58,58.5161979352083,54.6666666666667,55.1531980538744
84405,59,3,6,62,62.1602987647228,59,59.1525423728814,59.4285714285714,59.5822218574301
83714,33,4,4,37,37.5436179981635,37,37.5436179981635,34.2,34.702479338843
83803,40,12,4,52,56.68,60,65.4,53.2,57.988
83766,42,7,7,49,50.3611111111111,49,50.3611111111111,44.625,45.8645833333333
84028,44,5,4,49,49.6327479338843,50,50.6456611570248,46,46.5940082644628
83860,35,7,2,42,43.68,47,48.88,42,43.68
83792,38,3,8,41,41.255540166205,36,36.2243767313019,38.3333333333333,38.5722530009234
83728,37,3,9,40,40.2629656683711,34,34.2235208181154,37.3,37.545215485756
83617,30,8,3,38,40.7022222222222,43,46.0577777777778,37,39.6311111111111
83713,47,10,7,57,59.5803531009507,60,62.7161611588954,52.625,55.0072996831145
83626,31,5,2,36,36.9365244536941,39,40.0145681581686,34.3333333333333,35.2265001734305
83569,28,6,4,34,35.5612244897959,36,37.6530612244898,31,32.4234693877551
83578,38,12,5,50,54.9861495844875,57,62.6842105263158,49,53.8864265927978
83846,48,11,3,59,62.0985243055556,67,70.5186631944444,61.75,64.9929470486111
84059,43,12,2,55,59.283396430503,65,70.0621957815035,65,70.0621957815035
83738,44,17,3,61,70.1058884297521,75,86.1957644628099,78,89.6435950413223
84970,44,8,5,52,53.7190082644628,55,56.8181818181818,48.6666666666667,50.2754820936639
83781,34,6,6,40,41.2456747404844,40,41.2456747404844,36.1428571428571,37.268413247652
83798,33,5,2,38,38.8723599632691,41,41.941230486685,36.3333333333333,37.1674318947046
83497,18,2,3,20,20.2469135802469,19,19.2345679012346,18.25,18.4753086419753
83491,26,8,3,34,37.2189349112426,39,42.6923076923077,33,36.1242603550296
83827,40,8,3,48,49.92,53,55.12,47,48.88
84155,32,4,6,36,36.5625,34,34.53125,32.8571428571429,33.3705357142857
83825,41,5,7,46,46.6841165972635,44,44.6543723973825,42.25,42.8783462224866
83892,39,4,2,43,43.4523339907955,45,45.4733727810651,41,41.431295200526
84263,54,8,7,62,63.360768175583,63,64.3827160493827,57.5,58.7620027434842
83676,35,9,5,44,46.909387755102,48,51.1738775510204,41,43.7110204081633
84208,40,9,3,49,51.480625,55,57.784375,49,51.480625
83889,40,5,8,45,45.703125,42,42.65625,41.1111111111111,41.7534722222222
83812,39,3,8,42,42.2485207100592,37,37.2189349112426,39.3333333333333,39.5660749506903
83813,27,6,2,33,34.6296296296296,37,38.8271604938272,32,33.5802469135802
83839,32,6,1,38,39.3359375,43,44.51171875,39.5,40.888671875
84096,49,7,3,56,57.1428571428571,60,61.2244897959184,54.25,55.3571428571429
83789,43,5,10,48,48.6489994591671,43,43.5813953488372,43.9090909090909,44.5027779143517
83897,41,8,3,49,50.8655562165378,54,56.0559190957763,48,49.8274836406901
83900,39,8,3,47,48.9776462853386,52,54.1880341880342,46,47.9355687047995
83912,40,5,5,45,45.703125,45,45.703125,41.6666666666667,42.3177083333333
83980,36,5,7,41,41.7908950617284,39,39.7523148148148,37.25,37.9685570987654
83939,30,1,4,31,31.0344444444444,28,28.0311111111111,30,30.0333333333333
83836,27,4,4,31,31.6803840877915,31,31.6803840877915,28.2,28.8189300411523
84000,36,6,4,42,43.1666666666667,44,45.2222222222222,39,40.0833333333333
84092,20,4,3,24,24.96,25,26,21.5,22.36
83968,27,2,3,29,29.159122085048,28,28.1536351165981,27.25,27.3995198902606
83707,21,2,5,23,23.2086167800454,20,20.1814058956916,21.1666666666667,21.3586545729403
83861,23,4,2,27,27.8166351606805,29,29.8771266540643,25,25.7561436672968
84211,24,5,2,29,30.2586805555556,32,33.3888888888889,27.3333333333333,28.5196759259259
84045,22,4,1,26,26.8595041322314,29,29.9586776859504,25,25.8264462809917
83871,48,8,5,56,57.5555555555556,59,60.6388888888889,52.6666666666667,54.1296296296296
83840,41,5,5,46,46.6841165972635,46,46.6841165972635,42.6666666666667,43.3012095974618
83830,31,9,3,40,43.3714880332986,46,49.8772112382934,40,43.3714880332986
83771,36,6,4,42,43.1666666666667,44,45.2222222222222,39,40.0833333333333
84092,42,6,4,48,48.9795918367347,50,51.0204081632653,45,45.9183673469388
83895,36,7,8,43,44.6257716049383,42,43.587962962963,38.3333333333333,39.7826646090535
83816,39,8,7,47,48.9776462853386,48,50.0197238658777,42.5,44.2882971729126
84139,48,10,5,58,60.5173611111111,63,65.734375,55.5,57.9088541666667
85315,12,2,3,14,14.3888888888889,13,13.3611111111111,12.25,12.5902777777778
85375,37,6,5,43,44.1307523739956,44,45.1570489408327,39.5,40.5387143900657
85324,34,5,3,39,39.8434256055363,41,41.886678200692,36.5,37.2893598615917
85887,31,7,3,38,39.9375650364204,42,44.1415192507804,36.25,38.0983350676379
85206,24,4,5,28,28.7777777777778,27,27.75,25,25.6944444444444
85449,59,14,9,73,77.1103131284114,78,82.3918414248779,68.1,71.9344153978742
85330,31,6,4,37,38.3860561914672,39,40.4609781477628,34,35.2736732570239
85414,47,12,6,59,62.8460842009959,65,69.2372114078769,56.4285714285714,60.1070296837612
85358,46,8,9,54,55.6332703213611,53,54.6030245746692,48.8,50.2759924385633
85145,22,5,4,27,28.3946280991736,28,29.4462809917355,24,25.2396694214876
85289,28,4,5,32,32.6530612244898,31,31.6326530612245,29,29.5918367346939
85417,44,8,9,52,53.7190082644628,51,52.6859504132231,46.8,48.3471074380165
85248,19,4,3,23,24.0193905817175,24,25.0637119113573,20.5,21.4085872576177
85642,47,8,4,55,56.5934812132186,59,60.7093707559982,52.6,54.1239474875509
85303,20,4,6,24,24.96,22,22.88,20.8571428571429,21.6914285714286
85541,23,8,1,31,34.7504725897921,38,42.5973534971645,37,41.476370510397
85441,40,14,5,54,60.615,63,70.7175,55.1666666666667,61.9245833333333
85215,9,2,2,11,11.5432098765432,11,11.5432098765432,9.33333333333333,9.79423868312757
85329,29,9,4,38,41.6599286563615,43,47.141498216409,36.2,39.6865636147444
85522,37,5,7,42,42.7669831994156,40,40.7304601899197,38.25,38.9485025566107
85192,18,4,4,22,23.0864197530864,22,23.0864197530864,19.2,20.1481481481481
85299,20,3,2,23,23.5175,24,24.54,21,21.4725
85405,33,10,6,43,46.9485766758494,47,51.315886134068,39.4285714285714,43.0491932310114
85452,47,16,4,63,70.3010411951109,75,83.6917157084654,71,79.2281575373472
85175,19,7,5,26,29.5290858725762,28,31.8005540166205,22.5,25.5540166204986
85281,24,3,5,27,27.421875,25,25.390625,24.5,24.8828125
86351,23,0,2,23,23,21,21,23,23
85945,43,8,5,51,52.7652785289346,54,55.8691184424013,47.6666666666667,49.3165675139715
85694,34,8,2,42,44.3252595155709,48,50.6574394463668,43.3333333333333,45.7324106113033
85560,38,5,5,43,43.744459833795,43,43.744459833795,39.6666666666667,40.3534164358264
85534,47,8,9,55,56.5934812132186,54,55.5645088275238,49.8,51.2428248076052
85378,27,7,6,34,36.2853223593964,35,37.3525377229081,30,32.0164609053498
85596,13,3,0,16,16.8520710059172,19,20.0118343195266,16,16.8520710059172
85704,48,7,10,55,56.1697048611111,52,53.1059027777778,49.9090909090909,50.9705255681818
85559,31,5,4,36,36.9365244536941,37,37.9625390218522,33,33.8584807492196
85750,38,3,4,41,41.255540166205,40,40.2493074792244,38.6,38.8405817174515
85285,13,2,2,15,15.3550295857988,15,15.3550295857988,13.3333333333333,13.6489151873767
85261,19,4,5,23,24.0193905817175,22,22.9750692520776,20,20.8864265927978
85605,54,9,7,63,64.75,65,66.8055555555555,58.5,60.125
85674,52,12,6,64,67.4082840236686,70,73.7278106508876,61.4285714285714,64.6999154691462
85585,37,12,3,49,54.1541271000731,58,64.1008035062089,53.5,59.127465303141
85550,11,2,0,13,13.4297520661157,15,15.495867768595,12,12.396694214876
85762,40,9,4,49,51.480625,54,56.73375,47.2,49.5895
85619,20,2,2,22,22.22,22,22.22,20.3333333333333,20.5366666666667
85438,13,4,3,17,18.6094674556213,18,19.7041420118343,14.5,15.8727810650888
85804,29,6,4,35,36.4982164090369,37,38.5838287752675,32,33.3697978596908
85536,29,7,5,36,38.0975029726516,38,40.2140309155767,32.5,34.3935790725327
85709,27,5,3,32,33.0973936899863,34,35.1659807956104,29.5,30.5116598079561
85899,50,9,6,59,60.9116,62,64.0088,55.1428571428571,56.9294857142857
85638,40,7,7,47,48.439375,47,48.439375,42.625,43.930390625
85531,20,2,3,22,22.22,21,21.21,20.25,20.4525
85591,40,13,5,53,58.598125,61,67.443125,53,58.598125
85502,18,5,1,23,24.7746913580247,27,29.0833333333333,23,24.7746913580247
85527,20,2,3,22,22.22,21,21.21,20.25,20.4525
85762,60,11,5,71,73.3863888888889,77,79.5880555555556,69.1666666666667,71.4914351851852
85706,58,12,8,70,72.9964328180737,74,77.1676575505351,65.3333333333333,68.1300039635355
85535,38,13,4,51,56.968836565097,60,67.0221606648199,53.6,59.8731301939058
85731,53,13,5,66,69.9708081167675,74,78.4521181915272,66,69.9708081167675
87879,64,3,5,67,67.147216796875,65,65.142822265625,64.5,64.6417236328125
87304,46,11,8,57,60.2594517958412,60,63.4310018903592,52.1111111111111,55.0909997899601
87431,57,13,13,70,73.6411203447214,70,73.6411203447214,62.5714285714286,65.8261443081388
87509,65,13,9,78,81.12,82,85.28,72.8,75.712
87477,58,12,6,70,72.9964328180737,76,79.2532699167657,67.4285714285714,70.3149312043486
87403,40,8,3,48,49.92,53,55.12,47,48.88
87509,57,11,10,68,70.5324715297015,69,71.5697137580794,62,64.3090181594337
87597,69,14,11,83,86.4169292165512,86,89.5404326822096,76.5833333333333,79.7361023594483
87496,46,3,3,49,49.2084120982987,49,49.2084120982987,46.75,46.9488421550095
87386,55,14,7,69,73.4707438016529,76,80.9242975206612,66.375,70.6756611570248
87534,61,13,10,74,77.360924482666,77,80.4971781779092,68.0909090909091,71.1834550829445
87518,58,11,10,69,71.4818668252081,70,72.5178359096314,63,65.2660523186683
87656,64,10,9,74,75.806640625,75,76.8310546875,68.5,70.17236328125
87485,51,14,4,65,69.8981161091888,75,80.6516724336794,69.2,74.4146097654748
87714,59,7,7,66,66.9290433783396,66,66.9290433783396,61.625,62.4924590634875
87524,49,9,10,58,59.9566847147022,57,58.9229487713453,52.2727272727273,54.0361970391125
87456,35,8,4,43,45.2465306122449,47,49.4555102040816,40.6,42.7211428571429
87427,55,13,8,68,71.7990082644628,73,77.078347107438,63.6666666666667,67.2235812672176
87524,57,13,12,70,73.6411203447214,71,74.693136349646,63,66.2770083102493
87713,50,11,8,61,63.9524,64,67.0976,56.1111111111111,58.8268888888889
88359,58,11,8,69,71.4818668252081,72,74.589774078478,64.1111111111111,66.4171290791386
89718,55,5,10,60,60.495867768595,55,55.4545454545455,55.9090909090909,56.3711495116454
89052,58,8,3,66,67.2556480380499,71,72.3507728894174,65,66.2366230677764
88739,59,7,2,66,66.9290433783396,71,71.9994254524562,66,66.9290433783396
88847,57,5,3,62,62.4770698676516,64,64.492459218221,59.5,59.9578331794398
88676,60,9,6,69,70.5525,72,73.62,65.1428571428571,66.6085714285714
89011,67,4,5,71,71.253063042994,70,70.2494987747828,68,68.2423702383604
88617,48,5,6,53,53.5750868055556,52,52.5642361111111,49.4285714285714,49.9649057539683
88576,56,12,6,68,71.1224489795918,74,77.3979591836735,65.4285714285714,68.432944606414
88383,44,4,11,48,48.396694214876,41,41.3388429752066,44.5,44.8677685950413
88682,56,14,7,70,74.375,77,81.8125,67.375,71.5859375
88416,56,10,13,66,68.1045918367347,63,65.0089285714286,59.2142857142857,61.1024963556851
88455,51,3,5,54,54.1868512110727,52,52.1799307958478,51.5,51.6782006920415
88460,56,9,4,65,66.6788903061224,70,71.8080357142857,63.2,64.8323979591837
88537,57,10,9,67,69.0621729763004,68,70.0929516774392,61.5,63.3928901200369
88498,56,8,5,64,65.3061224489796,67,68.3673469387755,60.6666666666667,61.9047619047619
88662,55,9,4,64,65.7137190082645,69,70.8476033057851,62.2,63.865520661157
88711,59,8,9,67,68.231829933927,66,67.2134444125251,61.8,62.9362252226372
88338,53,7,10,60,61.0466358134567,57,57.9943040227839,54.9090909090909,55.8669212595877
88500,51,10,6,61,63.3452518262207,65,67.4990388312188,57.4285714285714,59.636513428901
88398,50,7,6,57,58.1172,58,59.1368,53,54.0388
88498,49,10,8,59,61.457309454394,61,63.5406080799667,54,56.2490628904623
88704,52,12,2,64,67.4082840236686,74,77.9408284023669,74,77.9408284023669
88568,49,11,2,60,63.0237401082882,69,72.4773011245314,67.3333333333333,70.726641677079
88876,61,8,3,69,70.1867777479172,74,75.2727761354475,68,69.1695780704112
88670,58,6,5,64,64.6848989298454,65,65.6956004756242,60.5,61.1474435196195
88819,56,4,6,60,60.3061224489796,58,58.2959183673469,56.8571428571429,57.1472303206997
88780,53,7,5,60,61.0466358134567,62,63.0815236739053,56.5,57.4855820576718
88809,59,7,10,66,66.9290433783396,63,63.8868141338696,60.9090909090909,61.766472539239
88676,50,3,3,53,53.1908,53,53.1908,50.75,50.9327
88935,59,5,8,64,64.4596380350474,61,61.4380925021546,60.1111111111111,60.5428197516678
88873,58,8,7,66,67.2556480380499,67,68.2746730083234,61.5,62.6700356718193
88568,46,11,7,57,60.2594517958412,61,64.4881852551985,52.875,55.898570415879
89832,43,6,5,49,49.9540292049757,50,50.9734991887507,45.5,46.3858842617631
90217,53,5,3,58,58.5161979352083,60,60.5339978640085,55.5,55.9939480242079
89750,43,6,3,49,49.9540292049757,52,53.0124391563007,46.75,47.6602217414819
89405,42,10,5,52,54.9478458049887,57,60.2312925170068,49.5,52.3061224489796
89773,55,10,5,65,67.1487603305785,70,72.3140495867768,62.5,64.5661157024793
89969,35,5,4,40,40.8163265306122,41,41.8367346938776,37,37.7551020408163
89670,58,8,6,66,67.2556480380499,68,69.2936979785969,62,63.179548156956
89644,41,8,4,49,50.8655562165378,53,55.0178465199286,46.6,48.3741820345033
89496,46,10,4,56,58.6465028355388,62,64.930056710775,55,57.5992438563327
89800,32,1,2,33,33.0322265625,32,32.03125,32,32.03125
89536,50,10,4,60,62.4,66,68.64,59,61.36
89774,53,13,4,66,69.9708081167675,75,79.5122819508722,68.6,72.7272338910644
89434,25,4,0,29,29.7424,33,33.8448,31,31.7936
89273,35,7,9,42,43.68,40,41.6,37.1,38.584
90310,50,8,2,58,59.4848,64,65.6384,59.3333333333333,60.8522666666667
89458,45,7,2,52,53.2582716049383,57,58.3792592592593,52,53.2582716049383
89678,52,10,5,62,64.292899408284,67,69.4778106508876,59.5,61.7004437869822
89367,40,9,6,49,51.480625,52,54.6325,45.1428571428571,47.4282142857143
89392,43,5,6,48,48.6489994591671,47,47.6354786371011,44.4285714285714,45.0292822375029
90345,64,6,5,70,70.615234375,71,71.6240234375,66.5,67.08447265625
89249,39,12,3,51,55.8284023668639,60,65.6804733727811,55.5,60.7544378698225
89389,49,14,7,63,68.1428571428572,70,75.7142857142857,60.375,65.3035714285714
89759,46,10,3,56,58.6465028355388,63,65.9773156899811,57.25,59.9555765595463
89843,62,8,7,70,71.165452653486,71,72.1821019771072,65.5,66.5905306971904
89570,38,7,3,45,46.5270083102493,49,50.6627423822715,43.25,44.7176246537396
89630,37,6,1,43,44.1307523739956,48,49.2622352081812,44.5,45.6701972242513
90233,59,8,7,67,68.231829933927,68,69.2502154553289,62.5,63.6490950876185
90280,58,5,8,63,63.468192627824,60,60.4458977407848,59.1111111111111,59.5504029594398
89475,53,10,4,63,65.2427910288359,69,71.4563901744393,62,64.2071911712353
89654,57,12,5,69,72.0581717451524,76,79.3684210526316,68,71.0138504155125
89368,29,4,3,33,33.627824019025,34,34.6468489892985,30.5,31.0802615933413
89289,33,11,7,44,48.8888888888889,48,53.3333333333333,39.875,44.3055555555556
89413,46,8,7,54,55.6332703213611,55,56.6635160680529,49.5,50.9971644612476
89331,45,8,5,53,54.6750617283951,56,57.7698765432099,49.6666666666667,51.236378600823
89306,38,11,7,49,53.1059556786704,53,57.441135734072,44.875,48.6353012465374
89903,49,4,11,53,53.3531861724282,46,46.3065389421075,49.5,49.8298625572678
89896,34,4,4,38,38.5259515570934,38,38.5259515570934,35.2,35.6871972318339
89536,39,8,5,47,48.9776462853386,50,52.1038790269559,43.6666666666667,45.5040543502082
89284,32,3,6,35,35.3076171875,32,32.28125,32.4285714285714,32.7135881696429
90000,32,5,4,37,37.9033203125,38,38.927734375,34,34.830078125
89513,36,4,3,40,40.4938271604938,41,41.5061728395062,37.5,37.962962962963
89615,35,5,3,40,40.8163265306122,42,42.8571428571429,37.5,38.265306122449
89428,47,10,8,57,59.5803531009507,59,61.6708918062472,52,54.3540063377094
90114,69,9,7,78,79.3270321361059,80,81.3610586011342,73.5,74.7504725897921
89708,60,5,6,65,65.4513888888889,64,64.4444444444444,61.4285714285714,61.8551587301587
89511,65,13,9,78,81.12,82,85.28,72.8,75.712
89880,35,7,1,42,43.68,48,49.92,45.5,47.32
89419,44,9,10,53,55.2174586776859,52,54.1756198347107,47.2727272727273,49.2505634861007
89571,35,7,2,42,43.68,47,48.88,42,43.68
89828,38,5,2,43,43.744459833795,46,46.7963988919668,41.3333333333333,42.0489381348107
89783,66,14,7,80,83.5996326905418,87,90.9146005509642,77.375,80.8565197428834
89965,57,7,2,64,64.9652200677131,69,70.0406278855032,64,64.9652200677131
89606,50,5,7,55,55.55,53,53.53,51.25,51.7625
89461,33,7,2,40,41.7998163452709,45,47.0247933884298,40,41.7998163452709
89871,39,5,2,44,44.7232084155161,47,47.7725180802104,42.3333333333333,43.029147490686
90110,55,5,6,60,60.495867768595,59,59.4876033057851,56.4285714285714,56.8949232585596
89406,60,11,11,71,73.3863888888889,71,73.3863888888889,64.5833333333333,66.7540509259259
91411,33,0,2,33,33,31,31,33,33
89590,39,5,5,44,44.7232084155161,44,44.7232084155161,40.6666666666667,41.3350865658558
89467,19,2,4,21,21.2326869806094,19,19.2105263157895,19.2,19.4127423822715
91457,35,4,3,39,39.509387755102,40,40.5224489795918,36.5,36.9767346938775
90489,57,10,9,67,69.0621729763004,68,70.0929516774392,61.5,63.3928901200369
90751,47,4,4,51,51.3693979176098,51,51.3693979176098,48.2,48.5491172476234
91000,69,7,12,76,76.782188615837,71,71.7307288384793,70.6153846153846,71.3421550094518
90863,61,10,4,71,72.9080892233271,77,79.0693361999463,70,71.8812147272239
90482,55,15,4,70,75.2066115702479,81,87.0247933884298,76,81.6528925619835
91033,62,7,6,69,69.8795525494277,70,70.8922996878252,65,65.8285639958377
90994,60,5,5,65,65.4513888888889,65,65.4513888888889,61.6666666666667,62.0949074074074
90707,58,5,9,63,63.468192627824,59,59.4384661117717,59,59.4384661117717
90732,56,11,9,67,69.5851403061225,69,71.6623086734694,61.5,63.8729272959184
90500,52,6,7,58,58.7721893491124,57,57.758875739645,53.875,54.5922707100592
90673,66,16,8,82,86.8191000918274,90,95.2892561983471,79.3333333333333,83.9957147229875
90632,64,9,5,73,74.443603515625,77,78.522705078125,70,71.38427734375
90755,66,8,6,74,75.0872359963269,76,77.1166207529844,70,71.0284664830119
90777,65,4,7,69,69.2613017751479,66,66.2499408284024,65.75,65.9989940828402
90437,60,11,11,71,73.3863888888889,71,73.3863888888889,64.5833333333333,66.7540509259259
90594,57,7,7,64,64.9652200677131,64,64.9652200677131,59.625,60.5242382271468
90445,58,8,10,66,67.2556480380499,64,65.217598097503,60.5454545454545,61.6973300183764
90557,66,16,8,82,86.8191000918274,90,95.2892561983471,79.3333333333333,83.9957147229875
90675,58,13,2,71,74.5668846611177,82,86.1195005945303,84,88.2199762187872
90717,54,8,7,62,63.360768175583,63,64.3827160493827,57.5,58.7620027434842
90806,61,6,3,67,67.6482128460091,70,70.6772373018006,64.75,65.3764445041655
90655,63,4,8,67,67.2700932224742,63,63.2539682539683,63.6666666666667,63.9233224153859
90469,57,5,8,62,62.4770698676516,59,59.4539858417975,58.1111111111111,58.5582572415444
90513,48,13,4,61,65.4743923611111,70,75.1345486111111,63.6,68.2651041666667
90881,61,9,4,70,71.5237839290513,75,76.6326256382693,68.2,69.6846009137329
90640,61,8,3,69,70.1867777479172,74,75.2727761354475,68,69.1695780704112
90867,64,9,3,73,74.443603515625,79,80.562255859375,73,74.443603515625
90601,52,8,6,60,61.4201183431953,62,63.4674556213018,56,57.3254437869822
90661,50,8,5,58,59.4848,61,62.5616,54.6666666666667,56.0661333333333
90501,62,11,10,73,75.297866805411,74,76.3293444328824,67,69.1090010405827
90691,57,6,9,63,63.6980609418282,60,60.6648199445983,58.5,59.1481994459834
90789,55,9,3,64,65.7137190082645,70,71.8743801652893,64,65.7137190082645
90539,47,12,4,59,62.8460842009959,67,71.3675871435039,60.2,64.1243096423721
90521,48,9,6,57,59.00390625,60,62.109375,53.1428571428571,55.0111607142857
90715,61,10,8,71,72.9080892233271,73,74.9618382155335,66,67.7737167428111
90946,53,7,8,60,61.0466358134567,59,60.0291918832325,55.3333333333333,56.2985641390768
90827,61,5,6,66,66.4434291857028,65,65.436710561677,62.4285714285714,62.8480055284678
91700,60,13,8,73,76.4269444444444,78,81.6616666666667,68.6666666666667,71.8901851851852
91435,66,16,13,82,86.8191000918274,85,89.9954086317723,74.5714285714286,78.9539551357733
91509,55,8,12,63,64.3328925619835,59,60.2482644628099,57.1538461538462,58.3630514939606
91877,60,13,10,73,76.4269444444444,76,79.5677777777778,67.0909090909091,70.2404545454546
91437,50,11,10,61,63.9524,62,65.0008,55,57.662
91546,55,9,8,64,65.7137190082645,65,66.7404958677686,59,60.5798347107438
91881,57,8,10,65,66.2803939673746,63,64.2409972299169,59.5454545454545,60.7184028652173
91882,64,9,7,73,74.443603515625,75,76.483154296875,68.5,69.8546142578125
91767,65,9,6,74,75.4186982248521,77,78.4762130177515,70.1428571428571,71.4876077768385
91908,74,16,4,90,94.2074506939372,102,106.768444119795,98,102.581446311176
91763,74,18,8,92,97.4433893352812,102,108.035062089116,91,96.3842220598977
91952,72,8,8,80,80.9876543209877,80,80.9876543209877,75.1111111111111,76.0384087791495
92043,79,10,6,89,90.4260535170646,93,94.4901458099664,85.4285714285714,86.7973996841166
91805,65,8,9,73,74.105798816568,72,73.090650887574,67.8,68.8270295857988
91752,67,12,11,79,81.534194698151,80,82.5662731120517,72.5,74.8256850077968
91473,57,8,13,65,66.2803939673746,60,61.1819021237304,59,60.1622037550015
91747,64,13,7,77,80.177001953125,83,86.424560546875,73.75,76.7929077148438
91871,72,11,7,83,84.9373070987654,87,89.0306712962963,78.875,80.7160252700617
91477,53,16,0,69,75.2883588465646,85,92.7465290138839,173,188.76646493414
91595,60,12,9,72,74.88,75,78,66.6,69.264
91634,67,10,8,77,78.7153040766318,79,80.7598574292716,72,73.6039206950323
91581,69,17,7,86,91.220331863054,96,101.827347195967,86,91.220331863054
91751,63,12,7,75,77.7210884353741,80,82.9024943310658,71.25,73.8350340136054
91767,70,11,13,81,83.0002040816326,79,80.9508163265306,73.9285714285714,75.7541545189504
91677,57,11,9,68,70.5324715297015,70,72.6069559864574,62.5,64.8276392736227
91869,60,8,6,68,69.2088888888889,70,71.2444444444444,64,65.1377777777778
91716,58,7,4,65,65.9467895362664,68,68.9904875148632,62.2,63.1060047562426
91714,53,11,7,64,66.7568529725881,68,70.9291562833749,59.875,62.4541651833393
92070,62,9,8,71,72.4960978147763,72,73.5171696149844,66,67.3907388137357
92083,82,15,13,97,100.245835812017,99,102.312760261749,89.5,92.4948691255205
91879,61,8,8,69,70.1867777479172,69,70.1867777479172,64.1111111111111,65.2138015467766
91755,69,6,10,75,75.5671077504726,71,71.5368620037807,70.3636363636364,70.8956865440797
92459,53,6,3,59,59.7561409754361,62,62.7945888216447,56.75,57.4773050907796
91704,47,4,3,51,51.3693979176098,52,52.3766410140335,48.5,48.8512901765505
91611,48,6,4,54,54.84375,56,56.875,51,51.796875
91744,67,8,7,75,76.0692804633549,76,77.0835375361996,70.5,71.5051236355536
91466,52,10,4,62,64.292899408284,68,70.5147928994083,61,63.2559171597633
92498,80,12,12,92,94.07,92,94.07,85.0769230769231,86.9911538461538
91934,71,18,10,89,94.7202935925412,97,103.234477286253,84.9090909090909,90.3664496582568
91715,69,10,7,79,80.6593152699013,82,83.722327242176,74.625,76.192422810334
92091,56,8,6,64,65.3061224489796,66,67.3469387755102,60,61.2244897959184
92584,75,14,8,89,92.1011555555556,95,98.3102222222222,85.1111111111111,88.0767604938272
92130,61,8,7,69,70.1867777479172,70,71.2039774254233,64.5,65.60937919914
91800,61,11,5,72,74.3413061005106,78,80.5364149422198,70.1666666666667,72.448356176655
91821,56,8,10,64,65.3061224489796,62,63.265306122449,58.5454545454545,59.7402597402597
91622,64,14,10,78,81.732421875,82,85.923828125,72.2727272727273,75.7310901988636
91913,58,4,4,62,62.294887039239,62,62.294887039239,59.2,59.4815695600476
92022,69,5,11,74,74.3885738290275,68,68.3570678428901,69.8333333333333,70.200028005321
92058,70,7,6,77,77.77,78,78.78,73,73.73
91623,60,12,7,72,74.88,77,80.08,68.25,70.98
92822,54,7,5,61,62.0250342935528,63,64.0586419753086,57.5,58.4662208504801
92557,54,8,8,62,63.360768175583,62,63.360768175583,57.1111111111111,58.3645785703399
92132,48,5,4,53,53.5750868055556,54,54.5859375,50,50.5425347222222
92435,43,6,4,49,49.9540292049757,51,51.9929691725257,46,46.8956192536506
91878,51,12,4,63,66.4878892733564,71,74.9307958477509,64.2,67.7543252595156
92319,57,9,7,66,67.6454293628809,68,69.6952908587258,61.5,63.0332409972299
91502,41,10,4,51,54.0339083878644,57,60.3908387864366,50,52.9744199881023
91796,49,13,4,62,66.3640149937526,71,75.9975010412328,64.6,69.1470220741358
91959,51,9,6,60,61.8685121107266,63,64.961937716263,56.1428571428571,57.8912506178942
92069,55,10,3,65,67.1487603305785,72,74.3801652892562,66.25,68.4400826446281
92021,50,9,5,59,60.9116,63,65.0412,56,57.8144
91919,62,10,8,72,73.8730489073881,74,75.9250780437045,67,68.7429760665973
91472,45,11,9,56,59.3461728395062,58,61.4656790123457,50.5,53.5175308641975
92703,62,15,5,77,81.5070239334027,87,92.0923517169615,79.5,84.1533558792924
91671,52,12,8,64,67.4082840236686,68,71.6213017751479,59.3333333333333,62.4930966469428
92074,61,13,11,74,77.360924482666,76,79.4517602794947,67.5,70.5657081429723
91944,59,6,11,65,65.6722206262568,60,60.620511347314,60.25,60.8730968112611
92215,69,14,5,83,86.4169292165512,92,95.7874396135266,84.1666666666667,87.6316250087517
92368,74,7,9,81,81.7247991234478,79,79.7069028487947,76.1,76.7809532505478
92083,66,7,8,73,73.8211662075298,72,72.8099173553719,68.3333333333333,69.1020048974594
91908,67,19,6,86,92.916016930274,99,106.961461349967,91.4285714285714,98.7811475670687
91981,66,11,5,77,79.1388888888889,83,85.3055555555555,75.1666666666667,77.2546296296296
91699,36,4,3,40,40.4938271604938,41,41.5061728395062,37.5,37.962962962963
92604,69,8,8,77,78.0350766645663,77,78.0350766645663,72.1111111111111,73.0804686223716
92158,53,11,7,64,66.7568529725881,68,70.9291562833749,59.875,62.4541651833393
91675,50,9,9,59,60.9116,59,60.9116,53.6,55.33664
91963,72,8,8,80,80.9876543209877,80,80.9876543209877,75.1111111111111,76.0384087791495
92156,54,10,5,64,66.1947873799726,69,71.3662551440329,61.5,63.6090534979424
92319,67,7,9,74,74.8077522833593,72,72.7859211405658,69.1,69.8542659835153
92051,53,10,4,63,65.2427910288359,69,71.4563901744393,62,64.2071911712353
92347,67,5,4,72,72.4009801737581,73,73.406549342838,69,69.3842726665182
93197,53,3,4,56,56.1794232823069,55,55.1762192951228,53.6,53.7717337130651
92723,60,5,10,65,65.4513888888889,60,60.4166666666667,60.9090909090909,61.3320707070707
92779,63,14,6,77,80.8024691358025,85,89.1975308641975,76,79.7530864197531
91985,57,5,12,62,62.4770698676516,55,55.4232071406587,57.7692307692308,58.2137462414471
92162,54,12,3,66,69.2592592592593,75,78.7037037037037,70.5,73.9814814814815
92355,41,7,4,48,49.3991671624033,51,52.4866151100535,45.2,46.5175490779298
92386,43,13,5,56,61.118442401298,64,69.8496484586263,56,61.118442401298
92679,28,4,2,32,32.6530612244898,34,34.6938775510204,30,30.6122448979592
93077,35,3,4,38,38.2791836734694,37,37.2718367346939,35.6,35.8615510204082
92575,49,4,6,53,53.3531861724282,51,51.3398583923365,49.8571428571429,50.1893853751413
92348,50,10,5,60,62.4,65,67.6,57.5,59.8
92414,31,6,7,37,38.3860561914672,36,37.3485952133195,32.875,34.1065296566077
92228,12,1,3,13,13.0902777777778,11,11.0763888888889,12,12.0833333333333
92329,27,5,1,32,33.0973936899863,36,37.2345679012346,32,33.0973936899863
92404,39,12,6,51,55.8284023668639,57,62.396449704142,48.4285714285714,53.0135249366019
92247,18,3,1,21,21.5833333333333,23,23.6388888888889,19.5,20.0416666666667
92298,15,2,2,17,17.3022222222222,17,17.3022222222222,15.3333333333333,15.6059259259259
92483,42,8,7,50,51.8140589569161,51,52.8503401360544,45.5,47.1507936507937
92605,39,5,3,44,44.7232084155161,46,46.7560815253123,41.5,42.1821170282709
92319,27,10,5,37,42.0754458161866,42,47.761316872428,34.5,39.2325102880658
92956,32,9,2,41,44.2431640625,48,51.796875,44,47.48046875
92416,43,3,5,46,46.2239048134127,44,44.2141698215251,43.5,43.7117360735533
92261,44,11,7,55,58.4375,59,62.6875,50.875,54.0546875
92233,38,7,7,45,46.5270083102493,45,46.5270083102493,40.625,42.0035491689751
92436,42,6,10,48,48.9795918367347,44,44.8979591836735,43.3636363636364,44.2486085343228
92687,46,4,5,50,50.3780718336484,49,49.3705103969754,47,47.3553875236295
92255,32,8,4,40,42.5,44,46.75,37.6,39.95
92825,23,5,0,28,29.3232514177694,33,34.5595463137996,33,34.5595463137996
92685,18,1,2,19,19.0586419753086,18,18.0555555555556,18,18.0555555555556
92499,49,14,6,63,68.1428571428572,71,76.7959183673469,62,67.0612244897959
92366,42,6,4,48,48.9795918367347,50,51.0204081632653,45,45.9183673469388
92384,17,4,1,21,22.1626297577855,24,25.3287197231834,20,21.1072664359862
92543,22,2,1,24,24.198347107438,25,25.2066115702479,22.5,22.6859504132231
92500,33,8,4,41,43.4095500459137,45,47.6446280991736,38.6,40.8685032139578
92985,40,10,7,50,53.125,53,56.3125,45.625,48.4765625
92729,29,5,3,34,35.0107015457788,36,37.0701545778835,31.5,32.436385255648
92726,16,1,1,17,17.06640625,17,17.06640625,16,16.0625
92491,39,10,3,49,52.2215647600263,56,59.6817882971729,50.25,53.5537475345168
92427,37,5,8,42,42.7669831994156,39,39.7121986851717,38.1111111111111,38.8070773476179
92863,28,7,3,35,37.1875,39,41.4375,33.25,35.328125
92476,21,4,4,25,25.907029478458,25,25.907029478458,22.2,23.0054421768707
92409,24,3,3,27,27.421875,27,27.421875,24.75,25.13671875
92392,23,3,4,26,26.4423440453686,25,25.4253308128544,23.6,24.0015122873346
92380,28,5,6,33,34.0522959183673,32,33.0204081632653,29.4285714285714,30.3669825072886
92222,14,2,2,16,16.3265306122449,16,16.3265306122449,14.3333333333333,14.6258503401361
92405,36,12,3,48,53.3333333333333,57,63.3333333333333,52.5,58.3333333333333
92589,49,16,3,65,71.9304456476468,78,86.3165347771762,79,87.4231570179092
92991,21,2,2,23,23.2086167800454,23,23.2086167800454,21.3333333333333,21.5268329554044
92877,29,6,3,35,36.4982164090369,38,39.6266349583829,32.75,34.1519024970273
92283,25,4,5,29,29.7424,28,28.7168,26,26.6656
92529,33,4,7,37,37.5436179981635,34,34.4995408631772,33.75,34.245867768595
92706,26,2,1,28,28.1656804733728,29,29.1715976331361,26.5,26.6568047337278
92759,23,4,3,27,27.8166351606805,28,28.8468809073724,24.5,25.2410207939509
92638,31,5,5,36,36.9365244536941,36,36.9365244536941,32.6666666666667,33.5164758931668
92445,15,2,1,17,17.3022222222222,18,18.32,15.5,15.7755555555556
92678,33,6,6,39,40.2892561983471,39,40.2892561983471,35.1428571428571,36.3046044864227
92802,28,7,5,35,37.1875,37,39.3125,31.5,33.46875
92664,23,4,1,27,27.8166351606805,30,30.9073724007561,26,26.7863894139887
92682,15,1,2,16,16.0711111111111,15,15.0666666666667,15,15.0666666666667
92629,53,17,5,70,77.2018511925952,82,90.436454254183,75.6666666666667,83.4515248605672
92975,50,5,6,55,55.55,54,54.54,51.4285714285714,51.9428571428571
93301,37,10,6,47,50.4331628926224,51,54.7253469685902,43.4285714285714,46.6008556819368
93347,35,8,4,43,45.2465306122449,47,49.4555102040816,40.6,42.7211428571429
93323,26,7,1,33,35.3920118343195,39,41.8269230769231,36.5,39.1457100591716
93349,26,3,3,29,29.3860946745562,29,29.3860946745562,26.75,27.1061390532544
93395,33,13,2,46,53.1386593204775,57,65.8457300275482,59,68.1561065197429
93472,23,4,1,27,27.8166351606805,30,30.9073724007561,26,26.7863894139887
93316,22,4,2,26,26.8595041322314,28,28.9256198347107,24,24.7933884297521
93406,24,7,1,31,33.6371527777778,37,40.1475694444444,34.5,37.4348958333333
93671,27,3,5,30,30.3703703703704,28,28.3456790123457,27.5,27.8395061728395
